cmun,municipality_clean,province_clean,0-17,18-24,25-34,35-54,55+,total_population
1001,alegria-dulantzi,araba/alava,1230,500,536,2010,1654,5930
1002,amurrio,araba/alava,3652,1176,1724,5922,8150,20624
1003,aramaio,araba/alava,436,226,216,698,1184,2760
1004,artziniega,araba/alava,704,254,292,1152,1310,3712
1006,arminon,araba/alava,84,40,36,192,140,492
1008,arratzua-ubarrundia,araba/alava,336,142,180,572,862,2092
1009,asparrena,araba/alava,458,220,290,888,1370,3226
1010,ayala/aiara,araba/alava,1100,416,452,1890,2020,5878
1011,banos,araba/alava,40,48,42,172,282,584
1013,barrundia,araba/alava,240,148,110,534,726,1758
1014,berantevilla,araba/alava,142,68,64,270,392,936
1016,bernedo,araba/alava,126,50,84,330,498,1088
1017,campezo/kanpezu,araba/alava,292,144,192,594,954,2176
1018,zigoitia,araba/alava,604,272,234,1090,1490,3690
1019,kripan,araba/alava,40,32,32,82,170,356
1020,kuartango,araba/alava,132,20,50,218,398,818
1021,elburgo/burgelu,araba/alava,212,98,94,412,466,1282
1022,elciego,araba/alava,314,122,166,520,784,1906
1023,elvillar/bilar,araba/alava,74,50,46,166,304,640
1027,iruraiz-gauna,araba/alava,142,84,102,332,440,1100
1028,labastida/bastida,araba/alava,612,216,292,894,1128,3142
1030,lagran,araba/alava,32,4,32,96,176,340
1031,laguardia,araba/alava,446,192,294,864,1186,2982
1032,lanciego/lantziego,araba/alava,270,74,144,372,518,1378
1033,lapuebla,araba/alava,290,112,178,490,642,1712
1034,leza,araba/alava,62,28,28,136,166,420
1036,laudio/llodio,araba/alava,5432,2234,2948,10114,15212,35940
1037,arraia-maeztu,araba/alava,298,84,102,534,628,1646
1039,moreda,araba/alava,40,22,68,98,202,430
1041,navaridas,araba/alava,58,22,58,96,172,406
1042,okondo,araba/alava,436,144,198,772,830,2380
1043,oyon-oion,araba/alava,1488,556,592,2118,2158,6912
1044,penacerrada-urizaharra,araba/alava,64,34,50,168,288,604
1046,erriberagoitia/ribera,araba/alava,230,102,150,516,690,1688
1047,ribera,araba/alava,496,262,290,918,916,2882
1049,anana,araba/alava,24,4,36,76,146,286
1051,agurain/salvatierra,araba/alava,2196,696,920,3170,3312,10294
1052,samaniego,araba/alava,98,44,64,128,246,580
1053,san,araba/alava,208,86,108,386,654,1442
1054,urkabustaiz,araba/alava,556,204,264,978,916,2918
1055,valdegovia/gaubea,araba/alava,198,116,194,514,1120,2142
1056,harana/valle,araba/alava,36,20,30,74,268,428
1057,villabuena,araba/alava,58,26,52,156,272,564
1058,legutio,araba/alava,754,242,384,1398,1386,4164
1059,vitoria-gasteiz,araba/alava,85894,35360,51166,154436,187958,514814
1060,yecora/iekora,araba/alava,76,46,50,120,236,528
1061,zalduondo,araba/alava,42,32,28,130,156,388
1062,zambrana,araba/alava,114,52,74,264,372,876
1063,zuia,araba/alava,648,434,452,1230,2018,4782
1901,iruna,araba/alava,1336,574,686,2600,2024,7220
1902,lantaron,araba/alava,206,118,152,498,878,1852
2001,abengibre,albacete,116,76,156,392,780,1520
2002,alatoz,albacete,86,72,76,246,530,1010
2003,albacete,albacete,61232,27234,39346,105912,114422,348146
2004,albatana,albacete,152,96,152,284,642,1326
2005,alborea,albacete,142,84,168,352,636,1382
2006,alcadozo,albacete,140,106,108,326,604,1284
2007,alcala,albacete,228,128,232,550,1128,2266
2008,alcaraz,albacete,352,186,240,704,1136,2618
2009,almansa,albacete,7854,3524,5134,14160,17972,48644
2010,alpera,albacete,712,338,494,1262,1756,4562
2011,ayna,albacete,62,42,112,280,718,1214
2012,balazote,albacete,784,368,630,1420,1568,4770
2013,balsa,albacete,12,12,10,74,148,256
2014,"ballestero,",albacete,108,40,68,206,400,822
2015,barrax,albacete,550,344,490,1084,1300,3768
2016,bienservida,albacete,102,44,122,246,588,1102
2017,bogarra,albacete,112,50,94,336,910,1502
2018,bonete,albacete,224,126,214,484,878,1926
2019,"bonillo,",albacete,574,424,574,1390,2286,5248
2020,carcelen,albacete,106,64,88,226,508,992
2021,casas,albacete,460,192,336,772,978,2738
2022,casas,albacete,8,36,50,130,402,626
2023,casas,albacete,88,74,98,238,612,1110
2024,casas-ibanez,albacete,1446,730,1058,2582,3310,9126
2025,caudete,albacete,3802,1504,2222,5790,7268,20586
2026,cenizate,albacete,372,174,300,626,862,2334
2027,corral-rubio,albacete,64,36,60,140,302,602
2028,cotillas,albacete,12,10,24,48,160,254
2029,chinchilla,albacete,1644,584,1120,3188,2800,9336
2030,elche,albacete,1096,472,824,1950,2834,7176
2031,ferez,albacete,140,102,112,298,564,1216
2032,fuensanta,albacete,52,20,36,166,324,598
2033,fuente-alamo,albacete,744,388,578,1282,1848,4840
2034,fuentealbilla,albacete,496,242,452,1008,1416,3614
2035,"gineta,",albacete,1008,302,620,1698,1590,5218
2036,golosalvo,albacete,8,10,12,30,108,168
2037,hellin,albacete,10724,5342,7576,18162,20042,61846
2038,"herrera,",albacete,80,32,72,178,268,630
2039,higueruela,albacete,278,170,250,588,1006,2292
2040,hoya-gonzalo,albacete,120,88,106,334,548,1196
2041,jorquera,albacete,40,46,54,210,364,714
2042,letur,albacete,164,138,216,394,930,1842
2043,lezuza,albacete,240,166,302,658,1270,2636
2044,lietor,albacete,172,134,220,508,1096,2130
2045,madrigueras,albacete,1624,592,962,2676,3442,9296
2046,mahora,albacete,472,204,330,878,1086,2970
2047,masegoso,albacete,0,10,18,40,162,230
2048,minaya,albacete,366,156,216,756,1318,2812
2049,molinicos,albacete,102,56,136,386,900,1580
2050,montalvos,albacete,16,4,8,36,98,162
2051,montealegre,albacete,582,298,456,1128,1626,4090
2052,motilleja,albacete,224,70,182,380,502,1358
2053,munera,albacete,932,532,790,1794,2736,6784
2054,navas,albacete,154,64,134,274,432,1058
2055,nerpio,albacete,218,162,218,610,1092,2300
2056,ontur,albacete,498,256,406,996,1622,3778
2057,ossa,albacete,538,298,446,1236,1912,4430
2058,paterna,albacete,62,20,52,184,360,678
2059,penascosa,albacete,42,28,66,168,354,658
2060,penas,albacete,246,156,306,852,1394,2954
2061,petrola,albacete,116,70,136,290,718,1330
2062,povedilla,albacete,60,46,74,188,420,788
2063,pozohondo,albacete,366,200,300,778,1450,3094
2064,pozo-lorente,albacete,46,54,90,176,412,778
2065,pozuelo,albacete,48,64,106,246,470,934
2066,"recueja,",albacete,22,36,50,90,244,442
2067,riopar,albacete,356,144,272,766,1166,2704
2068,robledo,albacete,96,34,104,212,340,786
2069,"roda,",albacete,5682,2492,3480,9164,10546,31364
2070,salobre,albacete,96,72,82,200,440,890
2071,san,albacete,222,188,276,686,1010,2382
2072,socovos,albacete,382,206,342,904,1500,3334
2073,tarazona,albacete,1972,980,1350,3332,4624,12258
2074,tobarra,albacete,2658,1248,1826,4500,5662,15894
2075,valdeganga,albacete,522,266,382,1114,1652,3936
2076,vianos,albacete,48,32,72,130,358,640
2077,villa,albacete,4,10,14,38,44,110
2078,villalgordo,albacete,260,180,278,584,992,2294
2079,villamalea,albacete,1232,630,914,2312,2906,7994
2080,villapalacios,albacete,110,66,134,268,548,1126
2081,villarrobledo,albacete,8976,4242,5756,14906,16536,50416
2082,villatoya,albacete,6,16,22,66,118,228
2083,villavaliente,albacete,18,16,48,78,248,408
2084,villaverde,albacete,56,26,48,138,356,624
2085,viveros,albacete,42,20,82,104,362,610
2086,yeste,albacete,490,280,456,1166,2668,5060
2901,pozo,albacete,938,448,584,1490,1932,5392
3001,"atzubia,",alicante/alacant,96,54,96,282,666,1194
3002,agost,alicante/alacant,1674,726,1136,2998,3666,10200
3003,agres,alicante/alacant,152,74,142,310,544,1222
3004,aigues,alicante/alacant,392,140,220,736,878,2366
3005,albatera,alicante/alacant,5570,2174,3358,7916,7506,26524
3006,alcalali,alicante/alacant,266,124,222,554,1588,2754
3007,alcosser,alicante/alacant,62,34,44,156,224,520
3008,alcoleja,alicante/alacant,46,8,30,90,206,380
3009,alcoi/alcoy,alicante/alacant,19238,9694,13182,34196,44584,120894
3010,alfafara,alicante/alacant,100,64,86,200,374,824
3011,alfàs,alicante/alacant,6012,2934,4082,11432,16390,40850
3012,algorfa,alicante/alacant,964,378,496,1736,3864,7438
3013,alguena,alicante/alacant,420,156,226,738,1124,2664
3014,alacant/alicante,alicante/alacant,121466,55248,83236,216848,240418,717216
3015,almoradi,alicante/alacant,9666,3634,5124,13782,12588,44794
3016,almudaina,alicante/alacant,16,22,26,64,108,236
3017,alqueria,alicante/alacant,150,90,106,366,322,1034
3018,altea,alicante/alacant,7346,3550,4922,14424,18456,48698
3019,aspe,alicante/alacant,8400,3322,4654,13644,13780,43800
3020,balones,alicante/alacant,16,22,30,58,138,264
3021,banyeres,alicante/alacant,2436,1162,1608,4146,5228,14580
3022,benasau,alicante/alacant,38,16,18,90,180,342
3023,beneixama,alicante/alacant,534,186,346,962,1360,3388
3024,benejuzar,alicante/alacant,2076,924,1330,3302,3806,11438
3025,benferri,alicante/alacant,818,278,422,1338,1252,4108
3026,beniarbeig,alicante/alacant,820,346,480,1514,1730,4890
3027,beniardà,alicante/alacant,52,32,40,146,214,484
3028,beniarres,alicante/alacant,194,152,226,528,1092,2192
3029,benigembla,alicante/alacant,100,52,70,248,668,1138
3030,benidoleig,alicante/alacant,266,140,210,636,1232,2484
3031,benidorm,alicante/alacant,21828,10034,17398,44838,55048,149146
3032,benifallim,alicante/alacant,22,16,14,72,108,232
3033,benifato,alicante/alacant,20,16,30,64,158,288
3034,benijofar,alicante/alacant,908,384,606,1568,3576,7042
3035,benilloba,alicante/alacant,142,94,138,362,762,1498
3036,benillup,alicante/alacant,34,10,18,68,90,220
3037,benimantell,alicante/alacant,148,44,116,312,464,1084
3038,benimarfull,alicante/alacant,92,52,80,240,428,892
3039,benimassot,alicante/alacant,8,10,24,40,110,192
3040,benimeli,alicante/alacant,128,40,38,210,494,910
3041,benissa,alicante/alacant,3772,1664,2308,6980,10066,24790
3042,poble,alicante/alacant,1460,480,880,2654,4444,9918
3043,biar,alicante/alacant,1182,510,682,2088,2806,7268
3044,bigastro,alicante/alacant,2922,1152,1856,4632,4270,14832
3045,bolulla,alicante/alacant,88,70,72,280,450,960
3046,busot,alicante/alacant,1036,486,608,2110,2958,7198
3047,calp,alicante/alacant,8502,3684,5908,15272,19908,53274
3048,callosa,alicante/alacant,2738,1238,1782,5116,5264,16138
3049,callosa,alicante/alacant,8642,3124,4482,11844,11076,39168
3050,"campello,",alicante/alacant,9928,4456,5720,18636,22778,61518
3051,camp,alicante/alacant,120,74,96,228,378,896
3052,canada,alicante/alacant,420,182,254,708,890,2454
3053,castalla,alicante/alacant,3878,1524,2740,7108,7946,23196
3054,castell,alicante/alacant,84,36,84,214,482,900
3055,catral,alicante/alacant,3500,1486,1872,5516,6612,18986
3056,cocentaina,alicante/alacant,3764,1576,2240,6368,8826,22774
3057,confrides,alicante/alacant,70,26,48,168,290,602
3058,cox,alicante/alacant,3128,1150,1766,4826,4346,15216
3059,crevillent,alicante/alacant,11888,4726,6706,18256,19284,60860
3060,quatretondeta,alicante/alacant,18,12,26,68,142,266
3061,daya,alicante/alacant,560,260,348,980,1562,3710
3062,daya,alicante/alacant,104,70,110,270,766,1320
3063,denia,alicante/alacant,14676,7176,10212,28268,34000,94332
3064,dolores,alicante/alacant,3158,1204,1942,4562,5304,16170
3065,elx/elche,alicante/alacant,87024,37864,53506,151046,155194,484634
3066,elda,alicante/alacant,18042,7702,11700,30952,39454,107850
3067,fageca,alicante/alacant,4,0,20,56,122,202
3068,famorca,alicante/alacant,0,2,10,10,66,88
3069,finestrat,alicante/alacant,3576,1048,2020,6712,5422,18778
3070,formentera,alicante/alacant,1642,684,958,2640,3572,9496
3071,gata,alicante/alacant,2102,1066,1524,3884,4812,13388
3072,gaianes,alicante/alacant,186,46,84,328,480,1124
3073,gorga,alicante/alacant,68,14,82,152,260,576
3074,granja,alicante/alacant,1102,386,582,1966,1410,5446
3075,castell,alicante/alacant,60,32,66,148,246,552
3076,guardamar,alicante/alacant,5748,2400,3286,10678,14014,36126
3077,fondo,alicante/alacant,552,272,412,1304,2910,5450
3078,hondon,alicante/alacant,238,92,144,542,1576,2592
3079,ibi,alicante/alacant,8012,3732,5198,14914,16722,48578
3080,jacarilla,alicante/alacant,630,322,512,1140,1642,4246
3081,xalo,alicante/alacant,894,326,524,1626,2776,6146
3082,xàbia/javea,alicante/alacant,9978,4300,6338,17258,23090,60964
3083,xixona/jijona,alicante/alacant,2298,972,1618,4144,5558,14590
3084,"orxa,",alicante/alacant,128,68,124,264,590,1174
3085,lliber,alicante/alacant,226,76,154,426,1102,1984
3086,millena,alicante/alacant,40,30,42,134,258,504
3088,monforte,alicante/alacant,3444,1296,2046,6474,4774,18034
3089,monòver/monovar,alicante/alacant,4226,1676,2614,7512,9488,25516
3090,mutxamel,alicante/alacant,10440,4518,5786,18438,16452,55634
3091,murla,alicante/alacant,106,48,68,220,728,1170
3092,muro,alicante/alacant,3434,1472,1824,5756,6164,18650
3093,novelda,alicante/alacant,8616,4170,5964,15892,17644,52286
3094,"nucia,",alicante/alacant,7076,2862,3666,12806,11584,37994
3095,ondara,alicante/alacant,2586,1078,1802,4782,4766,15014
3096,onil,alicante/alacant,2634,1150,1718,4858,5638,15998
3097,orba,alicante/alacant,616,216,326,1082,2586,4826
3098,orxeta,alicante/alacant,260,94,176,566,728,1824
3099,orihuela,alicante/alacant,27880,12040,16936,46916,62924,166696
3100,parcent,alicante/alacant,194,110,206,454,1098,2062
3101,pedreguer,alicante/alacant,2732,1154,1738,5082,6642,17348
3102,pego,alicante/alacant,3016,1514,1982,5982,8846,21340
3103,penàguila,alicante/alacant,58,38,54,166,276,592
3104,petrer,alicante/alacant,11612,5414,6588,21058,23506,68178
3105,"pinos,",alicante/alacant,2714,1254,1668,4934,6304,16874
3106,planes,alicante/alacant,132,94,120,320,736,1402
3107,polop,alicante/alacant,2136,700,1096,4006,3496,11434
3109,rafal,alicante/alacant,2090,928,1136,3032,2548,9734
3110,ràfol,alicante/alacant,176,72,114,362,714,1438
3111,redovan,alicante/alacant,3178,1382,2076,5178,4758,16572
3112,relleu,alicante/alacant,240,154,170,780,1236,2580
3113,rojales,alicante/alacant,3906,1574,2494,7166,18838,33978
3114,"romana,",alicante/alacant,756,344,436,1486,2338,5360
3115,sagra,alicante/alacant,98,32,62,228,464,884
3116,salinas,alicante/alacant,538,226,308,1036,1452,3560
3117,sanet,alicante/alacant,158,96,88,342,788,1472
3118,san,alicante/alacant,1838,762,1166,3836,11572,19174
3119,sant,alicante/alacant,8992,4298,5424,16136,16816,51666
3120,san,alicante/alacant,2210,770,1278,3562,6400,14220
3121,santa,alicante/alacant,12644,4924,8146,25350,25770,76834
3122,sant,alicante/alacant,21682,10454,13398,39680,35616,120830
3123,sax,alicante/alacant,3542,1526,2168,6018,7116,20370
3124,sella,alicante/alacant,126,60,114,386,528,1214
3125,senija,alicante/alacant,230,98,132,418,512,1390
3127,tàrbena,alicante/alacant,116,70,104,336,648,1274
3128,teulada,alicante/alacant,3512,1824,2624,6870,10884,25714
3129,tibi,alicante/alacant,458,202,352,1118,1514,3644
3130,tollos,alicante/alacant,0,4,8,20,44,76
3131,tormos,alicante/alacant,66,20,46,134,402,668
3132,torre,alicante/alacant,146,82,164,392,708,1492
3133,torrevieja,alicante/alacant,32222,12982,20626,57122,68568,191520
3134,vall,alicante/alacant,28,14,28,88,192,350
3135,vall,alicante/alacant,26,32,44,98,266,466
3136,vall,alicante/alacant,132,32,94,330,588,1176
3137,vall,alicante/alacant,210,72,134,482,922,1820
3138,"verger,",alicante/alacant,1674,664,1194,3314,3830,10676
3139,vila,alicante/alacant,12176,5360,8164,23336,24888,73924
3140,villena,alicante/alacant,12162,5198,7312,20352,23722,68746
3901,"poblets,",alicante/alacant,620,272,348,1336,2864,5440
3902,pilar,alicante/alacant,8472,3390,5276,13622,17030,47790
3903,"montesinos,",alicante/alacant,1928,784,1236,3142,4242,11332
3904,san,alicante/alacant,950,296,632,1550,1240,4668
4001,abla,almeria,336,152,290,652,1124,2554
4002,abrucena,almeria,278,148,266,610,1166,2468
4003,adra,almeria,9600,4258,6536,15748,14722,50864
4004,albanchez,almeria,126,78,84,304,770,1362
4005,alboloduy,almeria,138,60,102,326,540,1166
4006,albox,almeria,4634,1846,2914,7168,8458,25020
4007,alcolea,almeria,206,94,224,360,778,1662
4008,alcontar,almeria,92,62,114,240,604,1112
4009,alcudia,almeria,22,14,16,74,132,258
4010,alhabia,almeria,206,124,170,456,508,1464
4011,alhama,almeria,1426,594,978,2228,2582,7808
4012,alicun,almeria,48,32,52,104,192,428
4013,almeria,almeria,76000,31502,47156,121776,127458,403892
4014,almocita,almeria,44,22,56,114,190,426
4015,alsodux,almeria,8,10,20,76,160,274
4016,antas,almeria,1200,494,832,2106,2246,6878
4017,arboleas,almeria,586,340,450,1542,5674,8592
4018,armuna,almeria,54,66,78,160,302,660
4019,bacares,almeria,22,24,44,88,300,478
4020,bayarcal,almeria,74,52,48,168,258,600
4021,bayarque,almeria,38,56,26,116,210,446
4022,bedar,almeria,112,82,120,386,1252,1952
4023,beires,almeria,10,12,22,82,170,296
4024,benahadux,almeria,2200,706,1206,3134,2384,9630
4026,benitagla,almeria,6,2,10,32,68,118
4027,benizalon,almeria,32,20,42,138,268,500
4028,bentarique,almeria,54,18,20,128,236,456
4029,berja,almeria,4814,2122,3540,7722,7570,25768
4030,canjayar,almeria,210,122,228,552,1148,2260
4031,cantoria,almeria,890,438,622,1834,3352,7136
4032,carboneras,almeria,3194,1274,1924,5182,5338,16912
4033,castro,almeria,4,10,18,42,130,204
4034,cobdar,almeria,36,20,46,90,196,388
4035,cuevas,almeria,6490,2286,3654,9146,8656,30232
4036,chercos,almeria,56,54,60,188,262,620
4037,chirivel,almeria,436,180,312,784,1446,3158
4038,dalias,almeria,1554,638,1004,2420,2700,8316
4041,enix,almeria,144,70,110,396,486,1206
4043,felix,almeria,172,106,152,486,624,1540
4044,fines,almeria,774,332,598,1466,1380,4550
4045,finana,almeria,548,302,466,984,1736,4036
4046,fondon,almeria,242,150,202,622,1050,2266
4047,gador,almeria,1202,472,804,1802,1868,6148
4048,"gallardos,",almeria,894,392,550,1482,2838,6156
4049,garrucha,almeria,4148,1738,2694,6914,5556,21050
4050,gergal,almeria,372,160,316,724,820,2392
4051,huecija,almeria,162,62,136,264,448,1072
4052,huercal,almeria,8858,3360,3986,13740,7452,37396
4053,huercal-overa,almeria,7940,3220,4610,12544,12836,41150
4054,illar,almeria,98,58,108,240,430,934
4055,instincion,almeria,162,90,70,258,424,1004
4056,laroya,almeria,52,26,52,128,164,422
4057,laujar,almeria,556,232,316,882,1324,3310
4058,lijar,almeria,78,32,76,194,410,790
4059,lubrin,almeria,322,164,206,718,1496,2906
4060,lucainena,almeria,238,74,162,468,514,1456
4061,lucar,almeria,230,94,164,474,694,1656
4062,macael,almeria,1788,830,1176,3266,3896,10956
4063,maria,almeria,248,164,240,594,1150,2396
4064,mojacar,almeria,1858,810,1248,3782,7212,14910
4065,nacimiento,almeria,120,78,122,268,420,1008
4066,nijar,almeria,15332,5452,10748,21696,13468,66696
4067,ohanes,almeria,72,64,100,268,594,1098
4068,olula,almeria,12,24,38,88,202,364
4069,olula,almeria,2212,1128,1516,3890,4112,12858
4070,oria,almeria,406,238,354,1084,2384,4466
4071,padules,almeria,80,60,52,212,474,878
4072,partaloa,almeria,90,62,94,288,1244,1778
4073,paterna,almeria,68,40,76,218,390,792
4074,pechina,almeria,1994,712,1046,2912,2356,9020
4075,pulpi,almeria,4626,2242,3640,7800,5938,24246
4076,purchena,almeria,528,252,308,826,1156,3070
4077,ragol,almeria,46,38,34,172,308,598
4078,rioja,almeria,642,234,382,1044,922,3224
4079,roquetas,almeria,44806,17482,30320,74780,49308,216696
4080,santa,almeria,26,28,38,124,272,488
4081,santa,almeria,142,72,140,270,386,1010
4082,senes,almeria,12,30,62,144,314,562
4083,seron,almeria,560,270,438,1154,1878,4300
4084,sierro,almeria,62,32,76,232,354,756
4085,somontin,almeria,98,72,114,288,480,1052
4086,sorbas,almeria,752,288,522,1302,2144,5008
4087,sufli,almeria,28,34,56,134,206,458
4088,tabernas,almeria,1364,574,1090,2426,2700,8154
4089,taberno,almeria,290,116,178,490,850,1924
4090,tahal,almeria,62,56,54,224,352,748
4091,terque,almeria,94,46,76,190,374,780
4092,tijola,almeria,1086,672,842,2024,2462,7086
4093,turre,almeria,1340,552,864,2342,3584,8682
4094,turrillas,almeria,40,30,54,140,262,526
4095,uleila,almeria,178,128,148,428,760,1642
4096,urracal,almeria,52,40,104,156,362,714
4097,velefique,almeria,8,14,56,102,312,492
4098,velez-blanco,almeria,420,234,422,1064,1764,3904
4099,velez-rubio,almeria,2042,958,1488,3522,5144,13154
4100,vera,almeria,7988,3192,4510,12606,10536,38832
4101,viator,almeria,2754,1004,1746,4324,2840,12668
4102,vicar,almeria,12654,4882,8854,18826,11794,57010
4103,zurgena,almeria,666,306,400,1466,3068,5906
4901,tres,almeria,94,60,106,290,600,1150
4902,"ejido,",almeria,40262,15038,23986,59322,40316,178924
4903,"mojonera,",almeria,3976,1566,2578,5202,3770,17092
4904,balanegra,almeria,1116,506,866,1956,1610,6054
5001,adanero,avila,34,38,38,138,182,430
5002,"adrada,",avila,946,376,498,1748,2102,5670
5005,albornos,avila,22,28,30,90,180,350
5007,aldeanueva,avila,10,10,8,54,120,202
5008,aldeaseca,avila,48,14,42,96,208,408
5010,"aldehuela,",avila,20,12,26,72,160,290
5012,amavida,avila,28,14,20,52,152,266
5013,"arenal,",avila,198,90,144,480,1064,1976
5014,arenas,avila,1762,752,1034,3504,5888,12940
5015,arevalillo,avila,6,4,14,18,76,118
5016,arevalo,avila,2500,1248,1556,4456,5956,15716
5017,aveinte,avila,0,2,18,28,98,146
5018,avellaneda,avila,0,2,4,8,32,46
5019,avila,avila,20448,8774,11982,33484,43550,118238
5021,barco,avila,680,298,348,1232,2056,4614
5022,"barraco,",avila,548,248,406,1026,1816,4044
5023,barroman,avila,10,16,36,64,224,350
5024,becedas,avila,8,4,10,56,232,310
5025,becedillas,avila,6,2,8,38,84,138
5026,bercial,avila,8,10,34,92,202,346
5027,"berlanas,",avila,58,42,64,156,326,646
5029,bernuy-zapardiel,avila,6,4,12,34,118,174
5030,berrocalejo,avila,16,4,12,34,46,112
5033,blascomillan,avila,20,18,34,68,196,336
5034,blasconuno,avila,0,0,0,6,22,28
5035,blascosancho,avila,16,10,18,58,94,196
5036,"bohodon,",avila,4,8,12,58,142,224
5037,bohoyo,avila,28,20,26,88,268,430
5038,bonilla,avila,20,24,20,84,178,326
5039,brabos,avila,0,2,10,12,50,74
5040,bularros,avila,0,4,6,20,80,110
5041,burgohondo,avila,336,116,246,688,1126,2512
5042,cabezas,avila,18,18,28,86,158,308
5043,cabezas,avila,8,6,6,38,108,166
5044,cabezas,avila,30,24,22,114,288,478
5045,cabizuela,avila,18,2,24,40,94,178
5046,canales,avila,8,4,2,24,32,70
5047,candeleda,avila,1324,600,838,2832,4460,10054
5048,cantiveros,avila,2,12,16,26,142,198
5049,cardenosa,avila,54,60,78,190,462,844
5051,"carrera,",avila,20,24,14,84,178,320
5052,casas,avila,2,2,12,34,114,164
5053,casasola,avila,4,0,4,32,90,130
5054,casavieja,avila,340,152,208,796,1312,2808
5055,casillas,avila,148,72,126,294,698,1338
5056,castellanos,avila,6,12,28,50,128,224
5057,cebreros,avila,966,486,610,1750,2690,6502
5058,cepeda,avila,4,4,12,36,78,134
5059,cillan,avila,8,2,22,16,108,156
5060,cisla,avila,8,12,22,36,130,208
5061,"colilla,",avila,126,58,86,250,222,742
5062,collado,avila,8,20,28,46,192,294
5063,collado,avila,0,0,2,6,34,42
5064,constanzana,avila,14,6,14,32,132,198
5065,crespos,avila,80,42,74,236,538,970
5066,cuevas,avila,92,50,104,248,542,1036
5067,chamartin,avila,2,6,14,36,68,126
5069,donjimeno,avila,4,6,8,42,84,144
5070,donvidas,avila,2,2,12,14,40,70
5072,espinosa,avila,30,6,14,68,80,198
5073,flores,avila,36,18,40,130,322,546
5074,fontiveros,avila,140,74,142,350,748,1454
5075,fresnedilla,avila,16,6,10,44,120,196
5076,"fresno,",avila,190,70,132,358,456,1206
5077,fuente,avila,22,22,10,76,174,304
5078,fuentes,avila,2,0,14,34,126,176
5079,gallegos,avila,6,2,12,28,70,118
5080,gallegos,avila,6,0,2,30,50,88
5081,garganta,avila,4,8,0,18,48,78
5082,gavilanes,avila,96,66,70,240,586,1058
5083,gemuno,avila,34,10,20,72,154,290
5084,gilbuena,avila,0,0,2,16,76,94
5085,gil,avila,16,6,2,28,44,96
5086,gimialcon,avila,2,4,14,42,90,152
5087,gotarrendura,avila,28,16,16,80,192,332
5088,grandes,avila,2,10,2,24,32,70
5089,guisando,avila,46,52,86,218,554,956
5090,gutierre-munoz,avila,2,2,14,32,80,130
5092,hernansancho,avila,18,10,14,76,166,284
5093,herradon,avila,116,42,82,322,484,1046
5094,herreros,avila,38,10,22,78,148,296
5095,higuera,avila,62,20,38,136,282,538
5096,hija,avila,10,4,14,26,100,154
5097,"horcajada,",avila,60,34,88,210,516,908
5099,horcajo,avila,68,42,58,216,492,876
5100,"hornillo,",avila,32,24,48,116,340,560
5101,hoyocasero,avila,18,32,52,144,374,620
5102,hoyo,avila,726,258,394,1218,1772,4368
5103,hoyorredondo,avila,2,2,10,30,78,122
5104,hoyos,avila,4,2,2,8,42,58
5105,hoyos,avila,58,44,66,162,386,716
5106,hoyos,avila,2,6,2,12,30,52
5107,hurtumpascual,avila,0,2,14,8,64,88
5108,junciana,avila,8,2,0,24,46,80
5109,langa,avila,104,58,112,228,416,918
5110,lanzahita,avila,186,116,130,456,760,1648
5112,losar,avila,22,12,16,66,92,208
5113,llanos,avila,10,0,2,30,84,126
5114,madrigal,avila,198,138,264,664,1338,2602
5115,maello,avila,118,64,130,382,714,1408
5116,malpartida,avila,10,4,6,38,122,180
5117,mamblas,avila,32,6,48,86,220,392
5118,mancera,avila,16,6,16,26,78,142
5119,manjabalago,avila,0,0,4,8,34,46
5120,marlin,avila,2,0,4,16,38,60
5121,martiherrero,avila,98,52,62,238,270,720
5122,martinez,avila,4,6,10,34,164,218
5123,mediana,avila,10,12,30,68,114,234
5124,medinilla,avila,4,0,12,26,114,156
5125,mengamunoz,avila,14,4,12,32,46,108
5126,mesegar,avila,2,2,6,20,104,134
5127,mijares,avila,158,58,126,344,774,1460
5128,mingorria,avila,102,32,86,214,380,814
5129,"miron,",avila,2,2,4,42,146,196
5130,mironcillo,avila,14,12,14,68,118,226
5131,miruena,avila,0,6,10,58,116,190
5132,mombeltran,avila,186,98,142,426,980,1832
5133,monsalupe,avila,8,6,8,20,76,118
5134,moraleja,avila,8,6,4,34,54,106
5135,munana,avila,146,52,124,246,428,996
5136,munico,avila,16,4,12,48,80,160
5138,munogalindo,avila,52,44,58,144,302,600
5139,munogrande,avila,8,2,28,20,100,158
5140,munomer,avila,20,16,34,54,98,222
5141,munopepe,avila,20,12,4,64,108,208
5142,munosancho,avila,4,6,18,30,118,176
5143,munotello,avila,0,0,8,16,74,98
5144,narrillos,avila,2,0,8,24,80,114
5145,narrillos,avila,0,0,4,20,44,68
5147,narros,avila,18,18,36,64,170,306
5148,narros,avila,2,4,4,14,34,58
5149,narros,avila,6,10,10,58,128,212
5151,navacepedilla,avila,18,10,4,60,106,198
5152,nava,avila,94,82,110,346,692,1324
5153,nava,avila,4,2,12,30,118,166
5154,navadijos,avila,4,0,4,18,30,56
5155,navaescurial,avila,12,4,2,32,64,114
5156,navahondilla,avila,58,64,54,200,334,710
5157,navalacruz,avila,14,20,22,108,256,420
5158,navalmoral,avila,84,28,48,166,474,800
5159,navalonguilla,avila,16,8,8,58,278,368
5160,navalosa,avila,40,16,76,140,372,644
5161,navalperal,avila,270,96,146,384,752,1648
5162,navalperal,avila,12,6,6,42,88,154
5163,navaluenga,avila,566,222,338,1142,2086,4354
5164,navaquesera,avila,2,2,8,16,58,86
5165,navarredonda,avila,100,46,82,254,426,908
5166,navarredondilla,avila,24,16,24,74,182,320
5167,navarrevisca,avila,58,26,66,152,300,602
5168,navas,avila,2374,802,1134,3220,3656,11186
5169,navatalgordo,avila,28,20,46,80,302,476
5170,navatejares,avila,4,8,0,12,76,100
5171,neila,avila,4,4,0,48,68,124
5172,niharra,avila,38,20,64,102,156,380
5173,ojos-albos,avila,16,4,6,72,98,196
5174,orbita,avila,10,10,4,50,68,142
5175,"oso,",avila,12,8,20,64,154,258
5176,padiernos,avila,80,30,38,150,252,550
5177,pajares,avila,14,8,26,74,152,274
5178,palacios,avila,84,46,68,218,388,804
5179,papatrigo,avila,42,34,34,88,244,442
5180,"parral,",avila,2,2,10,28,88,130
5181,pascualcobo,avila,0,0,6,18,54,78
5182,pedro,avila,122,62,110,344,908,1546
5183,pedro-rodriguez,avila,16,12,14,54,162,258
5184,peguerinos,avila,62,14,66,168,288,598
5185,penalba,avila,24,12,20,56,100,212
5186,piedrahita,avila,350,216,238,798,1710,3312
5187,piedralaves,avila,554,266,342,1344,1826,4332
5188,poveda,avila,4,6,6,8,42,66
5189,poyales,avila,90,58,72,242,522,984
5190,pozanco,avila,0,4,14,34,66,118
5191,pradosegar,avila,14,14,22,48,138,236
5192,puerto,avila,14,6,10,56,110,196
5193,rasueros,avila,6,12,18,52,234,322
5194,riocabado,avila,4,14,32,52,148,250
5195,riofrio,avila,6,2,22,96,256,382
5196,rivilla,avila,10,14,6,38,44,112
5197,salobral,avila,20,8,26,66,92,212
5198,salvadios,avila,6,6,12,32,84,140
5199,san,avila,10,4,14,22,48,98
5200,san,avila,4,4,0,14,48,70
5201,san,avila,54,58,90,250,528,980
5204,sanchidrian,avila,140,82,150,352,688,1412
5205,sanchorreja,avila,6,10,14,20,108,158
5206,san,avila,2,0,4,6,28,40
5207,san,avila,146,82,112,304,824,1468
5208,san,avila,0,2,4,16,58,80
5209,san,avila,2,2,4,28,96,132
5210,san,avila,6,0,8,36,90,140
5211,san,avila,56,62,98,184,454,854
5212,san,avila,30,28,20,146,250,474
5213,san,avila,2,4,12,40,112,170
5214,san,avila,0,0,0,10,50,60
5215,san,avila,16,8,18,82,182,306
5216,san,avila,34,8,50,110,236,438
5217,san,avila,6,10,16,46,66,144
5218,san,avila,14,10,18,54,118,214
5219,san,avila,14,0,16,22,36,88
5220,san,avila,128,54,104,256,460,1002
5221,santa,avila,30,28,44,120,390,612
5222,santa,avila,32,16,40,84,174,346
5224,santa,avila,8,8,22,40,126,204
5225,santa,avila,74,48,50,144,444,760
5226,santa,avila,14,4,20,28,78,144
5227,santa,avila,200,54,92,342,416,1104
5228,santiago,avila,6,20,10,86,212,334
5229,santo,avila,6,6,8,42,78,140
5230,santo,avila,2,6,8,48,88,152
5231,san,avila,20,28,28,82,174,332
5232,"serrada,",avila,34,20,20,74,124,272
5233,serranillos,avila,32,30,54,126,262,504
5234,sigeres,avila,4,0,4,12,70,90
5235,sinlabajos,avila,12,4,32,44,182,274
5236,solana,avila,14,6,10,50,120,200
5237,solana,avila,16,10,14,62,176,278
5238,solosancho,avila,114,92,142,394,774,1516
5239,sotalbo,avila,38,30,72,136,224,500
5240,sotillo,avila,1782,726,918,3018,3490,9934
5241,"tiemblo,",avila,1560,630,828,2554,3524,9096
5242,tinosillos,avila,184,92,164,454,624,1518
5243,tolbanos,avila,24,6,14,50,86,180
5244,tormellas,avila,0,2,4,10,54,70
5245,tornadizos,avila,148,74,100,288,330,940
5246,tortoles,avila,2,2,8,6,58,76
5247,"torre,",avila,34,12,30,74,282,432
5249,umbrias,avila,10,12,30,44,104,200
5251,vadillo,avila,0,0,0,34,66,100
5252,valdecasa,avila,8,2,10,26,66,112
5253,vega,avila,20,8,8,54,82,172
5254,velayos,avila,42,36,28,106,224,436
5256,villaflor,avila,2,4,16,44,132,198
5257,villafranca,avila,10,10,22,84,144,270
5258,villanueva,avila,16,14,16,46,140,232
5259,villanueva,avila,14,8,10,50,102,184
5260,villanueva,avila,10,4,4,68,116,202
5261,villar,avila,0,4,2,18,48,72
5262,villarejo,avila,30,24,54,132,388,628
5263,villatoro,avila,16,16,30,70,188,320
5264,vinegra,avila,8,0,12,24,60,104
5265,vita,avila,12,12,22,28,78,152
5266,zapardiel,avila,4,4,16,26,118,168
5267,zapardiel,avila,6,18,12,52,94,182
5901,san,avila,14,12,32,100,294,452
5902,santa,avila,44,44,72,132,348,640
5903,diego,avila,4,10,10,46,142,212
5904,santiago,avila,12,12,18,62,114,218
5905,villanueva,avila,6,16,34,102,296,454
6001,acedera,badajoz,242,110,150,480,628,1610
6002,aceuchal,badajoz,1828,854,1350,3172,3612,10816
6003,ahillones,badajoz,148,112,130,366,818,1574
6004,alange,badajoz,528,246,416,966,1462,3618
6005,"albuera,",badajoz,682,190,410,1206,1536,4024
6006,alburquerque,badajoz,1436,628,1082,2660,4184,9990
6007,alconchel,badajoz,448,230,376,910,1292,3256
6008,alconera,badajoz,250,92,156,422,594,1514
6009,aljucen,badajoz,54,28,66,130,232,510
6010,almendral,badajoz,320,182,298,626,974,2400
6011,almendralejo,badajoz,13336,5142,7960,21102,20934,68474
6012,arroyo,badajoz,1430,616,1048,2266,2750,8110
6013,atalaya,badajoz,44,34,54,124,260,516
6014,azuaga,badajoz,2312,1078,1504,4136,6182,15212
6015,badajoz,badajoz,53986,22698,33484,92192,99932,302292
6016,barcarrota,badajoz,998,580,762,1960,2658,6958
6017,baterno,badajoz,26,46,34,108,262,476
6018,benquerencia,badajoz,134,118,158,376,792,1578
6019,berlanga,badajoz,570,272,422,1182,1992,4438
6020,bienvenida,badajoz,514,368,412,1022,1720,4036
6021,bodonal,badajoz,276,108,192,522,888,1986
6022,burguillos,badajoz,830,402,650,1490,2582,5954
6023,cabeza,badajoz,1166,566,958,2190,4160,9040
6024,cabeza,badajoz,314,188,244,632,1142,2520
6025,calamonte,badajoz,1908,934,1454,3612,4382,12290
6026,calera,badajoz,224,152,186,500,772,1834
6027,calzadilla,badajoz,162,108,186,322,596,1374
6028,campanario,badajoz,1294,696,1072,2356,3992,9410
6029,campillo,badajoz,356,188,272,730,1096,2642
6030,capilla,badajoz,10,26,32,60,162,290
6031,carmonita,badajoz,122,90,122,244,468,1046
6032,"carrascalejo,",badajoz,10,12,14,42,76,154
6033,casas,badajoz,316,186,238,714,1288,2742
6034,casas,badajoz,60,20,38,110,184,412
6035,castilblanco,badajoz,150,76,120,392,948,1686
6036,castuera,badajoz,1468,736,1126,2888,4782,11000
6037,"codosera,",badajoz,420,266,364,1044,1940,4034
6038,cordobilla,badajoz,202,116,180,402,758,1658
6039,"coronada,",badajoz,686,320,544,1186,1562,4298
6040,corte,badajoz,306,192,306,664,906,2374
6041,cristina,badajoz,196,80,138,316,366,1096
6042,cheles,badajoz,386,174,310,632,852,2354
6043,don,badajoz,202,100,196,436,694,1628
6044,don,badajoz,14082,5580,8396,23046,24438,75542
6045,entrin,badajoz,172,76,116,316,456,1136
6046,esparragalejo,badajoz,420,220,328,814,1202,2984
6047,esparragosa,badajoz,300,136,230,490,708,1864
6048,esparragosa,badajoz,188,82,166,454,820,1710
6049,feria,badajoz,238,170,178,542,962,2090
6050,fregenal,badajoz,1394,664,1096,2590,3736,9480
6051,fuenlabrada,badajoz,500,232,336,920,1426,3414
6052,fuente,badajoz,1416,698,1118,2404,3548,9184
6053,fuente,badajoz,156,96,112,332,620,1316
6054,fuente,badajoz,2100,1118,1572,3774,4656,13220
6055,fuentes,badajoz,500,296,522,1108,1894,4320
6056,garbayuela,badajoz,84,46,96,236,488,950
6057,garlitos,badajoz,98,60,82,192,626,1058
6058,"garrovilla,",badajoz,652,364,460,1364,1754,4594
6059,granja,badajoz,428,206,380,932,1860,3806
6060,guarena,badajoz,2102,1028,1354,3684,5128,13296
6061,"haba,",badajoz,296,198,292,532,1110,2428
6062,helechosa,badajoz,108,60,100,314,542,1124
6063,herrera,badajoz,988,416,738,1850,2822,6814
6064,higuera,badajoz,186,102,190,416,882,1776
6065,higuera,badajoz,96,42,78,182,284,682
6066,higuera,badajoz,480,222,490,942,1580,3714
6067,higuera,badajoz,576,330,502,1138,1866,4412
6068,hinojosa,badajoz,164,66,110,250,388,978
6069,hornachos,badajoz,978,578,654,1852,2746,6808
6070,jerez,badajoz,2682,1348,2088,5312,6838,18268
6071,"lapa,",badajoz,76,40,70,134,272,592
6072,lobon,badajoz,1022,318,544,1662,1918,5464
6073,llera,badajoz,250,126,146,430,658,1610
6074,llerena,badajoz,1820,754,1266,3300,4178,11318
6075,magacela,badajoz,78,76,96,246,502,998
6076,maguilla,badajoz,256,122,188,528,772,1866
6077,malcocinado,badajoz,60,34,60,158,380,692
6078,malpartida,badajoz,94,74,126,254,492,1040
6079,manchita,badajoz,222,92,200,400,562,1476
6080,medellin,badajoz,714,286,536,1194,1744,4474
6081,medina,badajoz,290,164,214,586,1074,2328
6082,mengabril,badajoz,134,78,116,306,346,980
6083,merida,badajoz,21908,9542,12808,36750,38780,119788
6084,mirandilla,badajoz,370,192,296,694,942,2494
6085,monesterio,badajoz,1356,656,926,2454,3074,8466
6086,montemolin,badajoz,282,168,178,660,1246,2534
6087,monterrubio,badajoz,568,262,388,1120,2054,4392
6088,montijo,badajoz,5094,2208,3356,8748,11026,30432
6089,"morera,",badajoz,174,128,122,390,600,1414
6090,nava,badajoz,234,118,210,432,846,1840
6091,navalvillar,badajoz,1232,596,912,2432,3510,8682
6092,nogales,badajoz,192,78,152,330,528,1280
6093,oliva,badajoz,1382,688,1112,2648,4036,9866
6094,oliva,badajoz,548,244,372,886,1312,3362
6095,olivenza,badajoz,3988,1828,2640,6836,8180,23472
6096,orellana,badajoz,38,20,28,128,308,522
6097,orellana,badajoz,648,328,560,1344,2290,5170
6098,palomas,badajoz,258,100,142,366,456,1322
6099,"parra,",badajoz,328,218,334,676,1016,2572
6100,penalsordo,badajoz,100,68,138,310,1034,1650
6101,peraleda,badajoz,106,66,68,228,490,958
6102,puebla,badajoz,242,162,202,548,1060,2214
6103,puebla,badajoz,1936,904,1276,3526,4066,11708
6104,puebla,badajoz,146,90,198,324,638,1396
6105,puebla,badajoz,120,94,100,320,680,1314
6106,puebla,badajoz,138,56,96,262,370,922
6107,puebla,badajoz,528,246,398,1004,1442,3618
6108,puebla,badajoz,800,360,558,1520,2038,5276
6109,quintana,badajoz,1274,702,1052,2374,3518,8920
6110,reina,badajoz,12,18,22,62,170,284
6111,rena,badajoz,242,86,158,300,442,1228
6112,retamal,badajoz,110,50,88,220,392,860
6113,ribera,badajoz,990,500,670,1820,2420,6400
6114,risco,badajoz,20,6,26,46,156,254
6115,roca,badajoz,414,192,332,838,1126,2902
6116,salvaleon,badajoz,406,206,380,842,1476,3310
6117,salvatierra,badajoz,432,212,330,834,1308,3116
6118,sancti-spiritus,badajoz,12,16,14,62,184,288
6119,san,badajoz,304,128,180,484,638,1734
6120,santa,badajoz,1118,664,920,2172,2952,7826
6121,santa,badajoz,1440,702,862,2394,2884,8282
6122,santos,badajoz,2850,1172,1990,4514,5676,16202
6123,san,badajoz,1516,724,1120,2996,4056,10412
6124,segura,badajoz,370,272,392,844,1704,3582
6125,siruela,badajoz,384,182,372,816,1790,3544
6126,solana,badajoz,788,422,580,1326,1984,5100
6127,talarrubias,badajoz,944,488,702,1702,2668,6504
6128,talavera,badajoz,1836,762,1260,3284,3776,10918
6129,taliga,badajoz,192,100,122,350,556,1320
6130,tamurejo,badajoz,44,34,34,78,208,398
6131,torre,badajoz,350,160,302,674,1006,2492
6132,torremayor,badajoz,252,128,230,530,866,2006
6133,torremejia,badajoz,854,354,554,1250,1454,4466
6134,trasierra,badajoz,144,106,156,304,472,1182
6135,trujillanos,badajoz,490,224,342,836,888,2780
6136,usagre,badajoz,496,220,452,848,1442,3458
6137,valdecaballeros,badajoz,228,86,194,494,1090,2092
6138,valdetorres,badajoz,286,152,288,560,988,2274
6139,valencia,badajoz,82,48,92,222,516,960
6140,valencia,badajoz,178,102,160,362,616,1418
6141,valencia,badajoz,444,314,350,912,1758,3778
6142,valverde,badajoz,42,20,62,122,296,542
6143,valverde,badajoz,1440,732,978,2464,2848,8462
6144,valverde,badajoz,122,80,96,240,588,1126
6145,valverde,badajoz,262,144,250,548,816,2020
6146,valle,badajoz,206,142,250,502,1084,2184
6147,valle,badajoz,52,42,54,144,374,666
6148,valle,badajoz,342,158,224,614,882,2220
6149,villafranca,badajoz,4272,1950,2584,7096,8806,24708
6150,villagarcia,badajoz,238,118,194,480,758,1788
6151,villagonzalo,badajoz,360,178,274,590,1048,2450
6152,villalba,badajoz,370,214,378,790,1166,2918
6153,villanueva,badajoz,9040,3832,5552,15036,18000,51460
6154,villanueva,badajoz,978,564,806,1766,2474,6588
6155,villar,badajoz,544,296,494,1114,1716,4164
6156,villar,badajoz,318,214,310,692,1112,2646
6157,villarta,badajoz,48,52,68,166,454,788
6158,zafra,badajoz,5610,2470,3424,9934,11922,33360
6159,zahinos,badajoz,934,378,726,1582,1916,5536
6160,zalamea,badajoz,898,448,828,1726,2960,6860
6161,zarza-capilla,badajoz,44,26,62,132,330,594
6162,"zarza,",badajoz,1072,510,776,1806,2536,6700
6901,valdelacalzada,badajoz,970,366,624,1690,1856,5506
6902,pueblonuevo,badajoz,642,232,398,1158,1472,3902
6903,guadiana,badajoz,752,392,536,1454,1752,4886
7001,alaro,"balears,",2276,982,1260,3996,3652,12166
7002,alaior,"balears,",3206,1560,2394,6326,6830,20316
7003,alcudia,"balears,",7412,3660,6654,14720,11704,44150
7004,algaida,"balears,",2252,852,1112,4294,4158,12668
7005,andratx,"balears,",4274,1768,2978,8006,7450,24476
7006,artà,"balears,",2844,1280,2096,5186,5566,16972
7007,banyalbufar,"balears,",142,68,114,372,464,1160
7008,binissalem,"balears,",3646,1570,1882,6166,5314,18578
7009,buger,"balears,",428,132,226,790,826,2402
7010,bunyola,"balears,",2646,1284,1446,4686,4990,15052
7011,calvià,"balears,",17408,8076,13784,34578,33806,107652
7012,campanet,"balears,",932,364,668,1668,1992,5624
7013,campos,"balears,",4594,1732,2714,8010,7334,24384
7014,capdepera,"balears,",4092,1982,3866,8538,7654,26132
7015,ciutadella,"balears,",10128,5430,8232,20422,20130,64342
7016,consell,"balears,",1782,682,872,3050,2408,8794
7017,costitx,"balears,",578,168,312,1020,1006,3084
7018,deià,"balears,",178,82,244,436,524,1464
7019,escorca,"balears,",22,24,72,94,198,410
7020,esporles,"balears,",2008,788,1060,3332,3418,10606
7021,estellencs,"balears,",92,40,100,208,318,758
7022,felanitx,"balears,",7278,2728,4628,10966,12172,37772
7023,ferreries,"balears,",1752,782,1302,3092,3324,10252
7024,formentera,"balears,",3300,1466,3392,8764,6044,22966
7025,fornalutx,"balears,",214,134,122,392,570,1432
7026,eivissa,"balears,",16472,7600,17208,38216,26960,106456
7027,inca,"balears,",13960,5760,9270,22532,19270,70792
7028,lloret,"balears,",636,186,330,1082,1026,3260
7029,lloseta,"balears,",2566,988,1470,4132,3916,13072
7030,llubi,"balears,",970,388,550,1548,1608,5064
7031,llucmajor,"balears,",13918,6040,9018,26796,23846,79618
7032,mao,"balears,",9868,5104,7610,19012,19692,61286
7033,manacor,"balears,",18716,7702,12938,29282,27122,95760
7034,mancor,"balears,",732,242,296,1200,938,3408
7035,maria,"balears,",830,314,542,1354,1742,4782
7036,marratxi,"balears,",15346,6640,8306,25568,24254,80114
7037,"mercadal,","balears,",1832,968,1612,4018,3896,12326
7038,montuïri,"balears,",1124,448,650,1954,2220,6396
7039,muro,"balears,",3276,1180,2064,4848,4904,16272
7040,palma,"balears,",138828,71332,124158,282170,259980,876468
7041,petra,"balears,",1130,492,698,1838,2272,6430
7042,pollença,"balears,",5772,2402,4470,10300,12152,35096
7043,porreres,"balears,",2326,792,1322,3642,3700,11782
7044,"pobla,","balears,",6166,2370,3728,8748,8426,29438
7045,puigpunyent,"balears,",800,330,352,1346,1310,4138
7046,sant,"balears,",9464,3958,8760,21372,14214,57768
7047,sencelles,"balears,",1366,538,754,2652,2658,7968
7048,sant,"balears,",9696,3708,8594,23352,15610,60960
7049,sant,"balears,",840,244,490,1318,1598,4490
7050,sant,"balears,",2274,896,1534,5082,3990,13776
7051,sant,"balears,",3242,1428,2394,5870,6064,18998
7052,sant,"balears,",2140,1134,1658,4510,5078,14520
7053,santa,"balears,",676,258,432,1160,1312,3838
7054,santa,"balears,",13478,5568,11488,31440,22036,84010
7055,santa,"balears,",4720,2030,3744,8934,8082,27510
7056,santa,"balears,",3004,1230,1570,4906,4564,15274
7057,santanyi,"balears,",3990,1826,3412,7856,8572,25656
7058,selva,"balears,",1502,558,806,2666,3012,8544
7059,"salines,","balears,",1628,678,1162,3112,3578,10158
7060,sineu,"balears,",1612,722,950,2912,2750,8946
7061,soller,"balears,",4372,2106,3274,8292,9676,27720
7062,son,"balears,",4390,1820,3422,7624,7642,24898
7063,valldemossa,"balears,",576,274,496,1200,1548,4094
7064,"castell,","balears,",2170,1256,1906,5002,5398,15732
7065,vilafranca,"balears,",1538,580,1006,2310,2222,7656
7901,ariany,"balears,",350,134,232,596,764,2076
7902,migjorn,"balears,",450,244,488,1102,1090,3374
8001,abrera,barcelona,4966,2186,2462,8748,7600,25962
8002,aguilar,barcelona,122,36,38,186,200,582
8003,alella,barcelona,3820,1510,1754,6076,7240,20400
8004,alpens,barcelona,72,34,66,134,234,540
8005,ametlla,barcelona,3666,1574,1806,5946,5904,18896
8006,arenys,barcelona,5290,2296,3208,9726,12506,33026
8007,arenys,barcelona,3270,1536,1974,5882,6226,18888
8008,argençola,barcelona,98,12,70,134,168,482
8009,argentona,barcelona,4672,2156,2478,7696,8698,25700
8010,artes,barcelona,2170,968,1280,3700,3984,12102
8011,avià,barcelona,754,300,424,1340,1666,4484
8012,avinyo,barcelona,766,370,520,1282,1684,4622
8013,avinyonet,barcelona,538,272,332,1124,1224,3490
8014,aiguafreda,barcelona,748,400,514,1546,1956,5164
8015,badalona,barcelona,80560,34830,50762,137284,149002,452438
8016,bagà,barcelona,548,286,420,1108,2000,4362
8017,balenyà,barcelona,1352,650,898,2494,2604,7998
8018,balsareny,barcelona,934,458,650,1948,2660,6650
8019,barcelona,barcelona,474388,248596,529436,992468,1127528,3372416
8020,begues,barcelona,2996,1320,1462,4502,4598,14878
8021,bellprat,barcelona,10,6,12,32,78,138
8022,berga,barcelona,5492,2632,3782,9626,12858,34390
8023,bigues,barcelona,3680,1728,1906,6600,6156,20070
8024,borredà,barcelona,108,54,80,204,406,852
8025,"bruc,",barcelona,854,316,422,1760,1234,4586
8026,"brull,",barcelona,118,62,50,154,202,586
8027,"cabanyes,",barcelona,432,186,168,654,582,2022
8028,cabrera,barcelona,572,226,356,1272,998,3424
8029,cabrera,barcelona,1814,768,1006,2978,3462,10028
8030,cabrils,barcelona,2902,1522,1470,4426,5208,15528
8031,calaf,barcelona,1446,518,778,1960,2488,7190
8032,caldes,barcelona,1010,518,620,1998,2336,6482
8033,caldes,barcelona,6402,2962,3956,11258,12090,36668
8034,calders,barcelona,394,140,238,678,778,2228
8035,calella,barcelona,6676,3040,3976,12142,14580,40414
8036,calonge,barcelona,46,18,30,84,170,348
8037,calldetenes,barcelona,972,388,602,1654,1764,5380
8038,callus,barcelona,828,336,394,1358,1386,4302
8039,campins,barcelona,216,104,118,380,400,1218
8040,canet,barcelona,4920,2344,2752,9066,11188,30270
8041,canovelles,barcelona,7038,3070,3838,10696,9886,34528
8042,cànoves,barcelona,1232,482,642,2254,2008,6618
8043,canyelles,barcelona,1886,810,966,3806,3252,10720
8044,capellades,barcelona,1866,890,1176,3358,3826,11116
8045,capolat,barcelona,42,14,14,56,58,184
8046,cardedeu,barcelona,7460,3096,3548,12348,11730,38182
8047,cardona,barcelona,1330,608,864,2360,3970,9132
8048,carme,barcelona,244,134,150,490,620,1638
8049,casserres,barcelona,540,158,302,978,1372,3350
8050,castellar,barcelona,64,28,16,108,110,326
8051,castellar,barcelona,9116,4502,4936,15548,16500,50602
8052,castellar,barcelona,18,20,40,86,164,328
8053,castellbell,barcelona,1398,662,838,2778,2584,8260
8054,castellbisbal,barcelona,5104,2384,2754,8208,7480,25930
8055,castellcir,barcelona,302,122,148,476,508,1556
8056,castelldefels,barcelona,24762,11038,14872,46568,41152,138392
8057,castell,barcelona,8,10,12,46,62,138
8058,castellet,barcelona,954,370,558,1692,1756,5330
8059,castellfollit,barcelona,156,64,94,238,368,920
8060,castellfollit,barcelona,42,10,30,66,154,302
8061,castellgali,barcelona,870,324,470,1640,1374,4678
8062,castellnou,barcelona,612,236,202,1018,792,2860
8063,castelloli,barcelona,262,116,126,454,360,1318
8064,castellterçol,barcelona,882,438,554,1612,2046,5532
8065,castellvi,barcelona,586,284,340,1030,1188,3428
8066,castellvi,barcelona,738,310,408,1322,1418,4196
8067,centelles,barcelona,2714,1138,1498,4826,5366,15542
8068,cervello,barcelona,3590,1370,1918,6168,6220,19266
8069,collbato,barcelona,1860,988,754,3242,2850,9694
8070,collsuspina,barcelona,172,44,56,236,272,780
8071,copons,barcelona,144,54,54,236,216,704
8072,corbera,barcelona,5754,2686,3260,10200,9666,31566
8073,cornellà,barcelona,30336,14400,21538,55224,60894,182392
8074,cubelles,barcelona,6068,2606,3042,11540,11344,34600
8075,dosrius,barcelona,2438,884,1160,4294,3528,12304
8076,esparreguera,barcelona,7882,3708,4874,14274,14260,44998
8077,esplugues,barcelona,15702,7240,10272,27294,34892,95400
8078,"espunyola,",barcelona,86,28,60,138,214,526
8079,"estany,",barcelona,110,42,64,224,362,802
8080,figols,barcelona,8,10,4,22,40,84
8081,fogars,barcelona,202,88,76,340,300,1006
8082,fogars,barcelona,514,260,382,1048,1152,3356
8083,folgueroles,barcelona,858,482,358,1366,1460,4524
8084,fonollosa,barcelona,518,196,282,1026,1146,3168
8085,font-rubi,barcelona,486,224,276,814,1064,2864
8086,franqueses,barcelona,8172,3340,4552,13958,11312,41334
8087,gallifa,barcelona,38,26,38,104,142,348
8088,"garriga,",barcelona,6452,2792,3552,10516,11242,34554
8089,gavà,barcelona,17328,7490,9878,29950,31276,95922
8090,gaià,barcelona,66,22,40,102,126,356
8091,gelida,barcelona,3104,1294,1684,5366,4708,16156
8092,gironella,barcelona,1796,576,922,2832,4018,10144
8093,gisclareny,barcelona,4,0,0,20,36,60
8094,"granada,",barcelona,884,348,482,1430,1382,4526
8095,granera,barcelona,6,0,28,42,90,166
8096,granollers,barcelona,21532,10268,15632,38328,42034,127794
8097,gualba,barcelona,746,278,252,1218,992,3486
8098,sant,barcelona,1346,606,596,2184,2224,6956
8099,guardiola,barcelona,236,104,228,508,826,1902
8100,gurb,barcelona,1034,478,522,1542,1846,5422
8101,hospitalet,barcelona,91190,45320,78056,175114,174918,564598
8102,igualada,barcelona,15156,6834,9178,24440,27902,83510
8103,jorba,barcelona,276,130,218,496,534,1654
8104,"llacuna,",barcelona,300,110,192,600,766,1968
8105,"llagosta,",barcelona,4454,2140,2872,8008,8666,26140
8106,llinars,barcelona,3692,1804,2374,6500,7028,21398
8107,lliçà,barcelona,5758,2862,3092,10534,10204,32450
8108,lliçà,barcelona,2434,1162,1282,4032,4806,13716
8109,lluçà,barcelona,104,40,68,160,206,578
8110,malgrat,barcelona,6184,2912,3788,11594,14062,38540
8111,malla,barcelona,102,42,46,154,204,548
8112,manlleu,barcelona,8584,3470,5068,11892,13568,42582
8113,manresa,barcelona,29326,12588,18112,45878,53570,159474
8114,martorell,barcelona,10580,5278,6362,17422,17324,56966
8115,martorelles,barcelona,1774,712,1048,2996,3438,9968
8116,masies,barcelona,278,102,146,412,560,1498
8117,masies,barcelona,1106,572,712,1956,2238,6584
8118,"masnou,",barcelona,7982,3378,5082,15186,17260,48888
8119,masquefa,barcelona,3712,1804,2102,6690,5732,20040
8120,matadepera,barcelona,4078,1940,1850,5518,6340,19726
8121,mataro,barcelona,47246,20482,29136,81228,83682,261774
8122,mediona,barcelona,990,344,420,1842,1668,5264
8123,molins,barcelona,9914,4350,5424,16966,17206,53860
8124,mollet,barcelona,17324,9212,11482,32024,34048,104090
8125,montcada,barcelona,14284,5910,8576,23366,22056,74192
8126,montgat,barcelona,4688,1756,2576,8778,7494,25292
8127,monistrol,barcelona,1150,386,714,2138,1988,6376
8128,monistrol,barcelona,210,118,142,466,588,1524
8129,muntanyola,barcelona,264,110,128,484,438,1424
8130,montclar,barcelona,54,14,28,68,100,264
8131,montesquiu,barcelona,422,138,224,638,768,2190
8132,montmajor,barcelona,160,62,84,270,372,948
8133,montmaneu,barcelona,56,20,36,120,168,400
8134,figaro-montmany,barcelona,352,146,300,714,868,2380
8135,montmelo,barcelona,2802,1500,1870,5306,6296,17774
8136,montornes,barcelona,6604,2750,3648,11012,10064,34078
8137,montseny,barcelona,126,32,62,250,288,758
8138,moià,barcelona,2248,1142,1548,4054,4438,13430
8139,mura,barcelona,62,42,28,138,194,464
8140,navarcles,barcelona,1936,846,1260,3564,4710,12316
8141,navàs,barcelona,2092,850,1264,3544,4616,12366
8142,nou,barcelona,36,24,36,78,152,326
8143,òdena,barcelona,1442,616,730,2300,2302,7390
8144,olvan,barcelona,248,118,166,530,758,1820
8145,olerdola,barcelona,1474,662,740,2536,2464,7876
8146,olesa,barcelona,754,328,370,1516,1216,4184
8147,olesa,barcelona,9362,4126,5304,15976,14638,49406
8148,olivella,barcelona,1804,614,766,3382,2338,8904
8149,olost,barcelona,354,156,260,616,1040,2426
8150,oris,barcelona,102,62,100,204,230,698
8151,oristà,barcelona,172,48,112,314,496,1142
8152,orpi,barcelona,68,26,32,128,104,358
8153,òrrius,barcelona,298,118,156,542,498,1612
8154,pacs,barcelona,354,142,176,532,682,1886
8155,palafolls,barcelona,3774,1724,2054,6598,5716,19866
8156,palau-solità,barcelona,5418,2794,3244,9366,10066,30888
8157,pallejà,barcelona,4476,1998,2290,7544,7314,23622
8158,"papiol,",barcelona,1598,640,972,2732,2774,8716
8159,parets,barcelona,6718,3040,3942,12068,11990,37758
8160,perafita,barcelona,144,60,76,258,338,876
8161,piera,barcelona,6392,2984,3810,11578,10356,35120
8162,hostalets,barcelona,1300,546,658,2254,1706,6464
8163,pineda,barcelona,9468,4458,5856,17540,21508,58830
8164,pla,barcelona,554,168,244,946,792,2704
8165,pobla,barcelona,890,380,526,1484,1432,4712
8166,pobla,barcelona,240,116,206,522,1130,2214
8167,polinyà,barcelona,3638,1354,1678,6376,4072,17118
8168,pontons,barcelona,130,72,88,358,388,1036
8169,prat,barcelona,22860,9684,14220,40632,44424,131820
8170,prats,barcelona,160,74,92,326,456,1108
8171,prats,barcelona,832,348,636,1340,2236,5392
8172,premià,barcelona,9446,4442,5986,17420,20562,57856
8174,puigdàlber,barcelona,296,78,102,404,378,1258
8175,puig-reig,barcelona,1392,604,966,2380,3622,8964
8176,pujalt,barcelona,68,18,34,116,188,424
8177,"quar,",barcelona,14,12,2,30,30,88
8178,rajadell,barcelona,196,76,116,398,402,1188
8179,rellinars,barcelona,318,120,202,676,524,1840
8180,ripollet,barcelona,14976,6818,8448,25552,23066,78860
8181,roca,barcelona,3960,1914,2100,6968,6970,21912
8182,pont,barcelona,1548,658,854,2638,2580,8278
8183,roda,barcelona,2588,1094,1766,4102,4216,13766
8184,rubi,barcelona,30178,13644,18304,52234,48686,163046
8185,rubio,barcelona,70,26,58,142,184,480
8187,sabadell,barcelona,80102,35182,52064,132692,143088,443128
8188,sagàs,barcelona,58,32,22,98,98,308
8189,sant,barcelona,66,26,12,100,112,316
8190,saldes,barcelona,52,32,56,150,310,600
8191,sallent,barcelona,2198,996,1358,3982,5330,13864
8192,santpedor,barcelona,3024,1170,1328,4812,5080,15414
8193,sant,barcelona,564,202,296,982,882,2926
8194,sant,barcelona,14146,6570,9838,23560,23230,77344
8195,sant,barcelona,40,4,34,54,84,216
8196,sant,barcelona,10254,4838,5262,17764,15960,54078
8197,sant,barcelona,4210,2148,2282,7086,8158,23884
8198,sant,barcelona,2570,1056,1236,4268,4178,13308
8199,sant,barcelona,386,84,200,552,656,1878
8200,sant,barcelona,29082,13210,18532,51382,56970,169176
8201,sant,barcelona,126,58,102,278,584,1148
8202,sant,barcelona,6794,2954,4326,11424,11918,37416
8203,sant,barcelona,1456,480,708,2696,2284,7624
8204,sant,barcelona,1622,760,742,2752,2486,8362
8205,sant,barcelona,42300,18784,20622,59580,56012,197298
8206,sant,barcelona,412,160,188,614,682,2056
8207,sant,barcelona,1242,604,606,1924,1786,6162
8208,sant,barcelona,2840,1392,1568,5222,5056,16078
8209,sant,barcelona,3100,1540,1698,5522,6532,18392
8210,sant,barcelona,2302,1104,1584,4286,3972,13248
8211,sant,barcelona,15984,7720,9296,28592,31170,92762
8212,sant,barcelona,192,76,116,310,564,1258
8213,sant,barcelona,3560,1604,1746,5926,5614,18450
8214,vilassar,barcelona,3194,1458,1812,5588,6546,18598
8215,sant,barcelona,1258,652,852,2254,2352,7368
8216,sant,barcelona,6,6,2,16,22,52
8217,sant,barcelona,12406,5820,7690,21360,22748,70024
8218,sant,barcelona,3838,1864,2104,6704,7434,21944
8219,vilassar,barcelona,7368,3424,3880,12342,15324,42338
8220,sant,barcelona,1190,508,702,1888,2312,6600
8221,sant,barcelona,9062,2990,4042,13414,12122,41630
8222,sant,barcelona,974,414,544,1674,1628,5234
8223,sant,barcelona,828,332,516,1508,1976,5160
8224,sant,barcelona,440,186,332,796,766,2520
8225,sant,barcelona,58,8,20,80,114,280
8226,sant,barcelona,554,220,224,750,798,2546
8227,sant,barcelona,1188,546,652,2090,2294,6770
8228,sant,barcelona,96,60,98,188,278,720
8229,sant,barcelona,176,56,142,336,564,1274
8230,premià,barcelona,3862,1772,1882,6204,7428,21148
8231,sant,barcelona,11752,5446,6420,20362,20032,64012
8232,sant,barcelona,918,376,452,1556,1688,4990
8233,sant,barcelona,914,318,520,1616,1824,5192
8234,sant,barcelona,1764,826,924,3270,3062,9846
8235,sant,barcelona,1910,954,1042,3542,4172,11620
8236,sant,barcelona,992,402,556,1536,1536,5022
8237,sant,barcelona,656,328,376,1216,1678,4254
8238,sant,barcelona,7930,3686,3556,12092,12956,40220
8239,sant,barcelona,232,114,102,496,398,1342
8240,sant,barcelona,4712,2122,2700,7612,8684,25830
8241,sant,barcelona,10,4,10,68,78,170
8242,marganell,barcelona,84,32,68,218,218,620
8243,santa,barcelona,72,16,44,110,142,384
8244,santa,barcelona,3304,1616,1380,5584,4784,16668
8245,santa,barcelona,42568,18860,28842,74630,76906,241806
8246,santa,barcelona,740,356,534,1342,1628,4600
8247,santa,barcelona,646,206,310,978,832,2972
8248,santa,barcelona,3060,1244,1370,5260,4898,15832
8249,santa,barcelona,124,70,66,228,232,720
8250,santa,barcelona,4400,1606,2252,6234,6546,21038
8251,santa,barcelona,3236,1222,1548,5136,4294,15436
8252,barberà,barcelona,12288,5032,6798,21646,21524,67288
8253,santa,barcelona,42,20,38,76,152,328
8254,"esquirol,",barcelona,712,288,502,1184,1864,4550
8255,santa,barcelona,82,24,26,118,100,350
8256,santa,barcelona,308,140,188,540,568,1744
8257,santa,barcelona,36,20,22,84,112,274
8258,santa,barcelona,352,128,160,638,878,2156
8259,santa,barcelona,3552,1684,1924,6198,6630,19988
8260,santa,barcelona,9758,4634,5326,16434,15720,51872
8261,santa,barcelona,1556,600,800,2590,2452,7998
8262,sant,barcelona,3672,1496,2028,6420,6646,20262
8263,sant,barcelona,10002,4916,6194,17422,18656,57190
8264,sant,barcelona,2364,1320,1036,4064,4666,13450
8265,sant,barcelona,742,326,402,1246,1464,4180
8266,cerdanyola,barcelona,18180,10150,12736,33358,41238,115662
8267,sentmenat,barcelona,3784,1512,1906,6338,5506,19046
8268,cercs,barcelona,324,128,216,652,1066,2386
8269,seva,barcelona,1296,578,678,2408,2642,7602
8270,sitges,barcelona,10170,4878,6296,20866,22782,64992
8271,sobremunt,barcelona,46,20,28,40,68,202
8272,sora,barcelona,82,24,48,130,154,438
8273,subirats,barcelona,1076,502,702,1864,2430,6574
8274,suria,barcelona,1946,870,1408,3196,4724,12144
8275,tavernoles,barcelona,134,30,74,210,234,682
8276,tagamanent,barcelona,108,54,70,260,186,678
8277,talamanca,barcelona,68,30,28,120,178,424
8278,taradell,barcelona,2498,1038,1332,4072,4716,13656
8279,terrassa,barcelona,85374,36798,52950,141378,140088,456588
8280,tavertet,barcelona,16,14,42,64,126,262
8281,teià,barcelona,2532,1120,1228,3902,4842,13624
8282,tiana,barcelona,3570,1556,1744,5770,6006,18646
8283,tona,barcelona,3036,1380,1826,5146,5610,16998
8284,tordera,barcelona,7080,2880,3770,12252,11608,37590
8285,torello,barcelona,5342,2300,3382,8974,10216,30214
8286,torre,barcelona,1426,708,820,2552,2724,8230
8287,torrelavit,barcelona,568,222,254,1032,942,3018
8288,torrelles,barcelona,970,410,604,1584,1756,5324
8289,torrelles,barcelona,2394,1008,1148,4168,3554,12272
8290,ullastrell,barcelona,982,370,324,1530,1152,4358
8291,vacarisses,barcelona,3150,1306,1536,5456,3650,15098
8292,vallbona,barcelona,496,226,232,858,998,2810
8293,vallcebre,barcelona,40,34,54,158,258,544
8294,vallgorguina,barcelona,1310,440,632,2360,1664,6406
8295,vallirana,barcelona,5882,2794,3132,10370,9726,31904
8296,vallromanes,barcelona,1078,548,472,1702,1698,5498
8297,veciana,barcelona,76,26,14,108,126,350
8298,vic,barcelona,19408,9134,12486,30056,27582,98666
8299,vilada,barcelona,108,32,84,228,434,886
8300,viladecavalls,barcelona,2864,1386,1440,4590,5300,15580
8301,viladecans,barcelona,24418,10934,13918,43182,41906,134358
8302,vilanova,barcelona,4954,2024,2674,8020,8034,25706
8303,vilanova,barcelona,76,24,60,196,278,634
8304,vilobi,barcelona,474,192,170,658,804,2298
8305,vilafranca,barcelona,15884,6670,8834,25130,26564,83082
8306,vilalba,barcelona,292,136,168,558,406,1560
8307,vilanova,barcelona,23000,10778,14586,42380,49842,140586
8308,viver,barcelona,70,28,22,78,148,346
8901,rupit,barcelona,52,26,48,142,294,562
8902,vilanova,barcelona,2366,994,928,3946,3054,11288
8903,sant,barcelona,60,28,44,122,208,462
8904,badia,barcelona,4378,2064,2768,7784,9224,26218
8905,palma,barcelona,980,438,744,1790,2144,6096
9001,abajas,burgos,4,0,6,8,38,56
9003,adrada,burgos,28,34,52,78,218,410
9006,aguas,burgos,8,2,6,24,78,118
9007,aguilar,burgos,4,6,4,26,60,100
9009,albillos,burgos,80,34,30,160,126,430
9010,alcocero,burgos,4,6,8,8,56,82
9011,alfoz,burgos,0,6,10,42,78,136
9012,alfoz,burgos,12,10,12,52,116,202
9013,altable,burgos,6,2,16,16,52,92
9014,"altos,",burgos,4,14,32,94,228,372
9016,ameyugo,burgos,38,12,18,64,82,214
9017,anguix,burgos,46,20,48,74,128,316
9018,aranda,burgos,11266,4564,7012,19548,24960,67350
9019,arandilla,burgos,24,4,36,78,168,310
9020,arauzo,burgos,44,34,46,124,296,544
9021,arauzo,burgos,16,0,10,28,38,92
9022,arauzo,burgos,6,4,2,28,82,122
9023,arcos,burgos,1088,210,216,1576,586,3676
9024,arenillas,burgos,44,6,38,62,188,338
9025,arija,burgos,22,10,20,58,120,230
9026,arlanzon,burgos,58,32,60,206,498,854
9027,arraya,burgos,10,2,10,32,52,106
9029,atapuerca,burgos,22,8,32,124,178,364
9030,"ausines,",burgos,30,12,18,86,184,330
9032,avellanosa,burgos,4,4,14,40,132,194
9033,bahabon,burgos,4,2,18,28,116,168
9034,"balbases,",burgos,44,20,54,148,346,612
9035,banos,burgos,86,42,48,172,292,640
9036,banuelos,burgos,0,2,4,16,40,62
9037,barbadillo,burgos,2,6,12,58,130,208
9038,barbadillo,burgos,12,8,24,50,172,266
9039,barbadillo,burgos,6,8,12,24,82,132
9041,barrio,burgos,14,2,2,16,30,64
9043,barrios,burgos,8,14,26,84,224,356
9044,barrios,burgos,2,0,8,36,64,110
9045,basconcillos,burgos,24,32,58,124,350,588
9046,bascunana,burgos,0,0,4,8,24,36
9047,belbimbre,burgos,8,8,12,34,48,110
9048,belorado,burgos,476,216,348,936,1696,3672
9050,berberana,burgos,2,2,10,34,48,96
9051,berlangas,burgos,48,24,44,88,202,406
9052,berzosa,burgos,0,0,2,14,36,52
9054,bozoo,burgos,16,4,8,52,124,204
9055,brazacorta,burgos,12,0,2,22,54,90
9056,briviesca,burgos,1894,1010,1314,3760,5116,13094
9057,bugedo,burgos,54,20,14,136,158,382
9058,buniel,burgos,280,90,110,498,244,1222
9059,burgos,burgos,56132,26036,34884,98364,137686,353102
9060,busto,burgos,14,18,24,54,176,286
9061,cabanes,burgos,4,6,30,78,180,298
9062,cabezon,burgos,0,0,0,8,64,72
9063,cavia,burgos,40,18,74,158,214,504
9064,caleruega,burgos,68,48,84,190,384,774
9065,campillo,burgos,48,24,14,114,144,344
9066,campolara,burgos,2,0,4,26,64,96
9067,canicosa,burgos,76,52,62,188,472,850
9068,cantabrana,burgos,0,8,2,0,36,46
9070,carazo,burgos,2,4,8,14,50,78
9071,carcedo,burgos,2,2,10,16,44,74
9072,carcedo,burgos,150,54,82,336,348,970
9073,cardenadijo,burgos,634,214,214,1136,662,2860
9074,cardenajimeno,burgos,444,192,190,766,744,2336
9075,cardenuela,burgos,26,10,24,54,108,222
9076,carrias,burgos,0,4,4,12,28,48
9077,cascajares,burgos,6,0,0,10,38,54
9078,cascajares,burgos,0,0,0,8,46,54
9079,castellanos,burgos,8,4,8,20,52,92
9082,castildelgado,burgos,2,0,0,22,46,70
9083,castil,burgos,2,0,2,12,40,56
9084,castrillo,burgos,16,4,14,72,210,316
9085,castrillo,burgos,216,90,110,366,458,1240
9086,castrillo,burgos,258,114,190,504,572,1638
9088,castrillo,burgos,2,0,6,30,78,116
9090,castrillo,burgos,4,8,6,24,62,104
9091,castrojeriz,burgos,110,76,142,358,874,1560
9093,cayuela,burgos,64,12,30,124,146,376
9094,cebrecos,burgos,6,6,18,30,56,116
9095,celada,burgos,16,6,2,50,106,180
9098,cerezo,burgos,68,40,82,204,588,982
9100,cerraton,burgos,0,2,6,20,62,90
9101,ciadoncha,burgos,6,6,4,30,100,146
9102,cillaperlata,burgos,0,0,2,18,40,60
9103,cilleruelo,burgos,36,20,22,94,246,418
9104,cilleruelo,burgos,4,10,2,22,60,98
9105,ciruelos,burgos,8,4,8,44,134,198
9108,cogollos,burgos,258,96,146,474,380,1354
9109,condado,burgos,520,184,242,1196,838,2980
9110,contreras,burgos,8,6,10,36,114,174
9112,coruna,burgos,8,18,16,40,118,200
9113,covarrubias,burgos,90,52,84,246,538,1010
9114,cubillo,burgos,22,12,32,52,86,204
9115,cubo,burgos,28,6,8,66,96,204
9117,cueva,burgos,8,6,14,42,110,180
9119,cuevas,burgos,4,0,2,22,62,90
9120,encio,burgos,4,4,0,22,52,82
9122,espinosa,burgos,8,4,14,40,104,170
9123,espinosa,burgos,0,4,4,18,58,84
9124,espinosa,burgos,428,142,234,910,1582,3296
9125,estepar,burgos,70,86,92,300,722,1270
9127,fontioso,burgos,8,0,2,30,68,108
9128,frandovinez,burgos,34,6,12,70,70,192
9129,fresneda,burgos,12,14,10,40,118,194
9130,fresnena,burgos,0,10,10,24,88,132
9131,fresnillo,burgos,298,98,94,478,424,1392
9132,fresno,burgos,16,8,34,62,202,322
9133,fresno,burgos,8,14,6,34,36,98
9134,frias,burgos,52,22,48,140,278,540
9135,fuentebureba,burgos,12,2,12,24,62,112
9136,fuentecen,burgos,54,26,36,108,244,468
9137,fuentelcesped,burgos,100,24,68,168,190,550
9138,fuentelisendo,burgos,18,10,14,48,112,202
9139,fuentemolinos,burgos,6,0,16,50,110,182
9140,fuentenebro,burgos,24,10,18,88,136,276
9141,fuentespina,burgos,296,106,96,534,600,1632
9143,galbarros,burgos,2,4,6,10,32,54
9144,"gallega,",burgos,2,2,8,14,52,78
9148,grijalba,burgos,40,12,26,72,86,236
9149,grisalena,burgos,12,10,6,30,48,106
9151,gumiel,burgos,138,100,80,300,546,1164
9152,gumiel,burgos,122,68,82,218,280,770
9154,hacinas,burgos,22,22,12,70,168,294
9155,haza,burgos,10,0,2,22,34,68
9159,hontanas,burgos,4,4,18,38,76,140
9160,hontangas,burgos,16,16,14,56,96,198
9162,hontoria,burgos,46,6,46,114,136,348
9163,hontoria,burgos,70,54,120,226,748,1218
9164,hontoria,burgos,26,10,30,84,186,336
9166,"hormazas,",burgos,14,10,6,38,130,198
9167,hornillos,burgos,4,0,10,18,62,94
9168,"horra,",burgos,86,26,44,144,298,598
9169,hortiguela,burgos,8,4,20,40,142,214
9170,hoyales,burgos,30,18,40,110,226,424
9172,huermeces,burgos,28,6,14,84,174,306
9173,huerta,burgos,4,4,18,52,178,256
9174,huerta,burgos,196,106,160,404,894,1760
9175,humada,burgos,0,2,8,48,174,232
9176,hurones,burgos,10,8,6,36,46,106
9177,ibeas,burgos,486,212,242,912,1066,2918
9178,ibrillos,burgos,0,2,4,6,46,58
9179,iglesiarrubia,burgos,2,0,16,14,58,90
9180,iglesias,burgos,26,0,32,70,154,282
9181,isar,burgos,18,24,48,112,368,570
9182,itero,burgos,4,2,16,32,88,142
9183,jaramillo,burgos,0,2,12,14,66,94
9184,jaramillo,burgos,4,0,0,6,10,20
9189,junta,burgos,14,8,10,64,148,244
9190,junta,burgos,4,8,10,36,96,154
9191,jurisdiccion,burgos,0,0,4,20,58,82
9192,jurisdiccion,burgos,2,6,8,32,84,132
9194,lerma,burgos,752,398,482,1416,2092,5140
9195,llano,burgos,4,4,10,14,66,98
9196,madrigal,burgos,6,14,22,62,184,288
9197,madrigalejo,burgos,48,12,38,104,150,352
9198,mahamud,burgos,0,18,26,32,134,210
9199,mambrilla,burgos,10,14,24,62,100,210
9200,mambrillas,burgos,2,2,14,24,70,112
9201,mamolar,burgos,4,4,2,16,30,56
9202,manciles,burgos,0,0,0,12,30,42
9206,mazuela,burgos,4,4,6,30,70,114
9208,mecerreyes,burgos,18,30,30,68,228,374
9209,medina,burgos,1722,792,1070,3434,4940,11958
9211,melgar,burgos,296,160,336,686,1556,3034
9213,merindad,burgos,28,12,46,120,334,540
9214,merindad,burgos,112,48,86,478,758,1482
9215,merindad,burgos,84,24,48,210,458,824
9216,merindad,burgos,66,44,70,188,464,832
9217,merindad,burgos,46,26,82,182,470,806
9218,milagros,burgos,114,48,56,228,390,836
9219,miranda,burgos,11494,4976,6682,20910,27988,72050
9220,miraveche,burgos,12,6,16,38,118,190
9221,modubar,burgos,318,82,140,606,388,1534
9223,monasterio,burgos,0,0,6,20,54,80
9224,monasterio,burgos,20,26,28,104,158,336
9225,moncalvillo,burgos,4,2,8,30,108,152
9226,monterrubio,burgos,0,2,4,14,92,112
9227,montorio,burgos,24,16,30,96,132,298
9228,moradillo,burgos,28,20,22,78,192,340
9229,nava,burgos,46,12,22,120,198,398
9230,navas,burgos,0,0,0,14,34,48
9231,nebreda,burgos,4,0,4,20,82,110
9232,neila,burgos,8,12,14,36,168,238
9235,olmedillo,burgos,44,10,22,120,174,370
9236,olmillos,burgos,0,0,14,16,50,80
9238,ona,burgos,100,78,104,362,1262,1906
9239,oquillas,burgos,6,2,12,20,58,98
9241,orbaneja,burgos,134,60,92,230,184,700
9242,padilla,burgos,4,0,10,22,102,138
9243,padilla,burgos,12,10,32,34,96,184
9244,padrones,burgos,6,6,8,26,72,118
9246,palacios,burgos,126,92,138,316,682,1354
9247,palacios,burgos,6,0,4,8,18,36
9248,palazuelos,burgos,6,4,22,44,110,186
9249,palazuelos,burgos,4,10,4,30,60,108
9250,pampliega,burgos,32,36,38,144,330,580
9251,pancorbo,burgos,112,56,78,260,368,874
9253,pardilla,burgos,14,10,18,66,96,204
9255,partido,burgos,0,4,6,28,124,162
9256,pedrosa,burgos,124,62,102,254,380,922
9257,pedrosa,burgos,6,0,22,48,104,180
9258,pedrosa,burgos,20,6,20,58,224,328
9259,pedrosa,burgos,28,30,48,102,284,492
9261,penaranda,burgos,110,28,70,206,514,928
9262,peral,burgos,24,10,22,92,192,340
9265,piernigas,burgos,2,2,8,18,48,78
9266,pineda,burgos,0,8,24,40,116,188
9267,pineda,burgos,2,12,12,48,122,196
9268,pinilla,burgos,4,8,10,54,120,196
9269,pinilla,burgos,6,0,2,12,46,66
9270,pinilla,burgos,10,16,22,68,208,324
9272,poza,burgos,28,24,50,130,332,564
9273,pradanos,burgos,4,8,12,24,64,112
9274,pradoluengo,burgos,192,100,196,474,1178,2140
9275,presencio,burgos,20,10,50,96,240,416
9276,puebla,burgos,212,62,116,424,302,1116
9277,puentedura,burgos,6,14,20,54,150,244
9279,quemada,burgos,60,28,30,136,230,484
9280,quintanabureba,burgos,0,2,0,18,42,62
9281,quintana,burgos,38,22,20,86,138,304
9283,quintanaelez,burgos,4,6,4,18,62,94
9287,quintanaortuno,burgos,104,56,52,186,180,578
9288,quintanapalla,burgos,32,4,14,78,118,246
9289,quintanar,burgos,318,156,254,716,1560,3004
9292,quintanavides,burgos,2,4,14,24,84,128
9294,quintanilla,burgos,16,14,16,46,124,216
9295,quintanilla,burgos,4,2,6,38,50,100
9297,"quintanillas,",burgos,90,36,82,234,338,780
9298,quintanilla,burgos,4,4,10,34,84,136
9301,quintanilla,burgos,332,128,164,638,538,1800
9302,rabanera,burgos,4,2,10,38,144,198
9303,rabanos,burgos,10,0,8,34,106,158
9304,rabe,burgos,56,12,40,108,292,508
9306,rebolledo,burgos,6,6,10,42,118,182
9307,redecilla,burgos,10,10,8,46,114,188
9308,redecilla,burgos,14,6,10,40,64,134
9309,regumiel,burgos,56,20,52,176,292,596
9310,reinoso,burgos,0,2,6,14,14,36
9311,retuerta,burgos,6,4,8,24,76,118
9312,revilla,burgos,18,6,10,56,112,202
9314,revilla,burgos,6,4,6,44,128,188
9315,revillarruz,burgos,284,66,120,572,266,1308
9316,revilla,burgos,18,8,22,68,114,230
9317,rezmondo,burgos,0,0,4,2,28,34
9318,riocavado,burgos,4,0,8,16,82,110
9321,roa,burgos,696,322,470,1304,1804,4596
9323,rojas,burgos,10,10,4,26,66,116
9325,royuela,burgos,6,6,22,52,256,342
9326,rubena,burgos,70,30,54,132,152,438
9327,rublacedo,burgos,8,0,2,26,36,72
9328,rucandio,burgos,0,2,4,40,98,144
9329,salas,burgos,22,14,28,62,132,258
9330,salas,burgos,540,270,366,1080,1720,3976
9332,saldana,burgos,64,22,50,142,126,404
9334,salinillas,burgos,0,4,10,20,60,94
9335,san,burgos,4,4,20,44,100,172
9337,san,burgos,42,26,18,100,122,308
9338,san,burgos,86,56,46,196,236,620
9339,san,burgos,16,6,16,66,174,278
9340,san,burgos,0,4,4,28,90,126
9343,santa,burgos,16,4,30,28,132,210
9345,santa,burgos,26,12,42,70,144,294
9346,santa,burgos,14,4,6,74,108,206
9347,santa,burgos,26,14,32,84,170,326
9348,santa,burgos,18,6,30,72,184,310
9350,santa,burgos,112,48,90,284,512,1046
9351,santa,burgos,4,2,8,34,86,134
9352,santa,burgos,6,10,6,56,138,216
9353,santa,burgos,10,26,14,42,102,194
9354,santa,burgos,8,0,0,26,42,76
9355,santibanez,burgos,2,2,4,28,116,152
9356,santibanez,burgos,4,16,14,32,74,140
9358,santo,burgos,18,24,44,122,286,494
9360,san,burgos,0,2,2,22,30,56
9361,sargentes,burgos,12,10,22,70,152,266
9362,sarracin,burgos,82,28,44,154,220,528
9363,sasamon,burgos,98,78,154,414,1080,1824
9365,sequera,burgos,2,2,2,24,24,54
9366,solarana,burgos,0,12,8,28,108,156
9368,sordillos,burgos,0,0,2,2,40,44
9369,sotillo,burgos,98,56,116,226,448,944
9372,sotragero,burgos,106,64,26,228,178,602
9373,sotresgudo,burgos,40,18,56,232,492,838
9374,susinos,burgos,22,20,22,44,128,236
9375,tamaron,burgos,2,12,16,28,52,110
9377,tardajos,burgos,262,124,128,460,754,1728
9378,tejada,burgos,0,12,4,18,36,70
9380,terradillos,burgos,2,2,16,30,78,128
9381,tinieblas,burgos,0,0,4,2,44,50
9382,tobar,burgos,0,4,6,8,36,54
9384,tordomar,burgos,52,22,66,166,290,596
9386,torrecilla,burgos,28,6,16,40,68,158
9387,torregalindo,burgos,36,8,26,58,118,246
9388,torrelara,burgos,0,2,8,18,36,64
9389,torrepadre,burgos,4,0,4,20,106,134
9390,torresandino,burgos,66,58,92,312,618,1146
9391,tortoles,burgos,54,24,70,194,430,772
9392,tosantos,burgos,6,2,16,20,62,106
9394,trespaderne,burgos,126,66,94,356,784,1426
9395,tubilla,burgos,8,10,16,64,158,256
9396,tubilla,burgos,20,10,34,112,168,344
9398,urbel,burgos,0,0,2,42,72,116
9400,vadocondes,burgos,100,30,66,194,336,726
9403,valdeande,burgos,10,2,22,44,120,198
9405,valdezate,burgos,14,16,22,44,148,244
9406,valdorros,burgos,130,36,92,278,216,752
9407,valmala,burgos,2,0,0,16,34,52
9408,vallarta,burgos,0,6,4,24,50,84
9409,valle,burgos,12,20,8,52,140,232
9410,valle,burgos,1216,468,690,2584,3336,8294
9411,valle,burgos,20,14,30,94,172,330
9412,valle,burgos,168,98,126,418,914,1724
9413,valle,burgos,116,36,76,246,502,976
9414,valle,burgos,24,10,20,88,238,380
9415,valle,burgos,56,32,42,166,360,656
9416,valle,burgos,8,2,10,10,60,90
9417,vallejera,burgos,2,0,8,16,52,78
9418,valles,burgos,4,14,8,32,92,150
9419,valluercanes,burgos,2,2,6,24,90,124
9421,vid,burgos,38,14,48,102,288,490
9422,vid,burgos,2,4,6,6,30,48
9423,vilena,burgos,0,0,0,16,38,54
9424,viloria,burgos,4,4,6,12,48,74
9425,vilviestre,burgos,46,52,94,234,582,1008
9427,villadiego,burgos,214,100,280,718,1598,2910
9428,villaescusa,burgos,8,8,16,42,110,184
9429,villaescusa,burgos,10,4,12,30,62,118
9430,villaespasa,burgos,0,0,2,8,34,44
9431,villafranca,burgos,10,4,28,46,156,244
9432,villafruela,burgos,12,8,30,42,194,286
9433,villagalijo,burgos,6,0,6,20,72,104
9434,villagonzalo,burgos,906,312,280,1352,908,3758
9437,villahoz,burgos,30,24,54,116,330,554
9438,villalba,burgos,200,100,140,400,578,1418
9439,villalbilla,burgos,674,166,294,1192,718,3044
9440,villalbilla,burgos,6,2,6,44,90,148
9441,villaldemiro,burgos,20,8,26,40,88,182
9442,villalmanzo,burgos,52,50,90,200,424,816
9443,villamayor,burgos,24,6,48,60,194,332
9444,villamayor,burgos,0,2,6,20,84,112
9445,villambistia,burgos,2,0,6,10,70,88
9446,villamedianilla,burgos,0,0,0,6,12,18
9447,villamiel,burgos,2,0,0,18,66,86
9448,villangomez,burgos,14,24,44,112,268,462
9449,villanueva,burgos,30,20,12,78,104,244
9450,villanueva,burgos,2,0,0,14,38,54
9451,villanueva,burgos,42,30,52,178,256,558
9454,villanueva,burgos,2,2,2,22,56,84
9455,villaquiran,burgos,2,2,16,10,62,92
9456,villaquiran,burgos,16,10,20,74,162,282
9458,villariezo,burgos,322,84,88,582,368,1444
9460,villasandino,burgos,26,16,24,68,222,356
9463,villasur,burgos,32,28,52,148,288,548
9464,villatuelda,burgos,18,4,12,28,44,106
9466,villaverde,burgos,4,8,20,16,168,216
9467,villaverde-mogina,burgos,12,12,14,42,70,150
9471,villayerno,burgos,62,44,24,126,154,410
9472,villazopeque,burgos,2,2,2,34,64,104
9473,villegas,burgos,0,4,18,38,98,158
9476,villoruebo,burgos,6,0,4,36,80,126
9478,vizcainos,burgos,0,4,10,14,52,80
9480,zael,burgos,4,10,40,38,140,232
9482,zarzosa,burgos,0,0,2,14,46,62
9483,zazuar,burgos,36,30,50,94,208,418
9485,zuneda,burgos,0,6,8,28,72,114
9901,quintanilla,burgos,32,20,50,176,396,674
9902,valle,burgos,66,36,86,238,532,958
9903,villarcayo,burgos,1132,452,736,2360,3406,8086
9904,valle,burgos,84,56,74,322,546,1082
9905,valle,burgos,58,34,84,204,438,818
9906,merindad,burgos,370,158,232,858,1212,2830
9907,alfoz,burgos,960,348,396,1570,1004,4278
9908,valle,burgos,72,24,58,344,494,992
10001,abadia,caceres,80,54,72,168,290,664
10002,abertura,caceres,56,48,70,176,392,742
10003,acebo,caceres,92,56,74,272,668,1162
10004,acehuche,caceres,260,78,154,446,670,1608
10005,aceituna,caceres,154,72,92,334,516,1168
10006,ahigal,caceres,302,144,254,646,1346,2692
10007,albala,caceres,92,70,168,260,722,1312
10008,alcantara,caceres,262,138,272,650,1374,2696
10009,alcollarin,caceres,46,32,54,126,272,530
10010,alcuescar,caceres,608,340,530,1310,2164,4952
10011,aldeacentenera,caceres,108,84,134,260,598,1184
10012,aldea,caceres,122,50,122,268,640,1202
10013,aldea,caceres,50,36,42,140,310,578
10014,aldeanueva,caceres,452,234,386,1028,1890,3990
10015,aldeanueva,caceres,154,66,112,380,688,1400
10016,aldehuela,caceres,86,50,50,176,342,704
10017,alia,caceres,104,60,90,382,854,1490
10018,aliseda,caceres,402,212,316,958,1566,3454
10019,almaraz,caceres,520,182,362,950,1226,3240
10020,almoharin,caceres,484,202,376,942,1584,3588
10021,arroyo,caceres,1402,666,1118,3054,4800,11040
10022,arroyomolinos,caceres,76,50,104,178,452,860
10023,arroyomolinos,caceres,152,106,200,384,810,1652
10024,banos,caceres,168,68,142,350,748,1476
10025,barrado,caceres,74,40,70,170,410,764
10026,belvis,caceres,188,90,158,430,640,1506
10027,benquerencia,caceres,8,6,4,42,106,166
10028,berrocalejo,caceres,20,18,36,46,132,252
10029,berzocana,caceres,60,24,68,160,476,788
10030,bohonal,caceres,90,46,96,178,596,1006
10031,botija,caceres,36,26,50,86,178,376
10032,brozas,caceres,426,216,312,832,1716,3502
10033,cabanas,caceres,62,36,64,170,480,812
10034,cabezabellosa,caceres,16,36,54,134,426,666
10035,cabezuela,caceres,608,308,406,1192,1814,4328
10036,cabrero,caceres,64,54,64,188,328,698
10037,caceres,caceres,31958,14430,19928,58646,67934,192896
10038,cachorrilla,caceres,12,4,18,40,92,166
10039,cadalso,caceres,40,68,70,170,464,812
10040,calzadilla,caceres,78,62,86,238,450,914
10041,caminomorisco,caceres,306,132,204,524,1092,2258
10042,campillo,caceres,4,6,6,32,120,168
10043,campo,caceres,166,100,172,422,752,1612
10044,canamero,caceres,420,228,228,894,1436,3206
10045,canaveral,caceres,190,108,218,466,1054,2036
10046,carbajo,caceres,34,10,24,84,200,352
10047,carcaboso,caceres,302,122,198,584,938,2144
10048,carrascalejo,caceres,24,12,34,70,312,452
10049,casar,caceres,1398,582,994,2636,3344,8954
10050,casar,caceres,196,72,152,452,1118,1990
10051,casares,caceres,16,28,42,136,530,752
10052,casas,caceres,24,26,18,84,204,356
10053,casas,caceres,80,44,66,170,296,656
10054,casas,caceres,86,74,130,292,586,1168
10055,casas,caceres,196,96,158,428,656,1534
10056,casas,caceres,90,52,100,288,604,1134
10057,casas,caceres,16,18,20,50,120,224
10058,casatejada,caceres,454,248,332,740,982,2756
10059,casillas,caceres,52,22,60,162,392,688
10060,castanar,caceres,218,100,214,486,1048,2066
10061,ceclavin,caceres,398,256,342,844,1722,3562
10062,cedillo,caceres,74,58,80,214,442,868
10063,cerezo,caceres,16,8,18,58,204,304
10064,cilleros,caceres,384,208,288,716,1510,3106
10065,collado,caceres,90,46,42,200,172,550
10066,conquista,caceres,48,24,34,84,178,368
10067,coria,caceres,3460,1716,2408,6958,9708,24250
10068,cuacos,caceres,200,74,152,422,810,1658
10069,"cumbre,",caceres,136,66,188,354,912,1656
10070,deleitosa,caceres,120,74,120,356,696,1366
10071,descargamaria,caceres,6,8,12,54,138,218
10072,eljas,caceres,120,66,120,392,976,1674
10073,escurial,caceres,272,110,164,502,702,1750
10075,fresnedoso,caceres,44,32,36,102,264,478
10076,galisteo,caceres,178,126,162,450,772,1688
10077,garciaz,caceres,104,72,116,308,728,1328
10078,"garganta,",caceres,24,32,38,138,478,710
10079,garganta,caceres,156,88,170,440,918,1772
10080,gargantilla,caceres,54,50,48,142,434,728
10081,garguera,caceres,6,22,32,88,222,370
10082,garrovillas,caceres,502,204,364,948,1916,3934
10083,garvin,caceres,34,10,18,46,94,202
10084,gata,caceres,292,138,210,746,1360,2746
10085,"gordo,",caceres,106,38,64,264,280,752
10086,"granja,",caceres,60,26,46,160,340,632
10087,guadalupe,caceres,388,222,304,886,1702,3502
10088,guijo,caceres,16,14,16,110,220,376
10089,guijo,caceres,370,206,390,742,1272,2980
10090,guijo,caceres,66,24,72,188,624,974
10091,guijo,caceres,90,36,38,182,404,750
10092,herguijuela,caceres,30,38,54,106,312,540
10093,hernan-perez,caceres,76,66,100,182,400,824
10094,herrera,caceres,40,18,30,100,264,452
10095,herreruela,caceres,64,36,68,170,328,666
10096,hervas,caceres,1062,520,694,2122,3446,7844
10097,higuera,caceres,10,6,34,40,108,198
10098,hinojal,caceres,34,26,76,128,512,776
10099,holguera,caceres,158,76,116,284,552,1186
10100,hoyos,caceres,208,100,152,496,768,1724
10101,huelaga,caceres,76,30,32,128,146,412
10102,ibahernando,caceres,76,74,140,216,584,1090
10103,jaraicejo,caceres,56,40,72,164,540,872
10104,jaraiz,caceres,2316,996,1458,3532,5146,13448
10105,jarandilla,caceres,710,398,514,1534,2526,5682
10106,jarilla,caceres,14,14,18,54,178,278
10107,jerte,caceres,318,164,236,648,1044,2410
10108,ladrillar,caceres,12,18,28,112,200,370
10109,logrosan,caceres,564,212,420,894,1730,3820
10110,losar,caceres,732,386,570,1528,2400,5616
10111,madrigal,caceres,280,172,296,774,1550,3072
10112,madrigalejo,caceres,384,230,362,908,1524,3408
10113,madronera,caceres,518,304,538,1120,2266,4746
10114,majadas,caceres,446,152,292,640,992,2522
10115,malpartida,caceres,1058,560,778,2218,3450,8064
10116,malpartida,caceres,1510,694,912,2792,3418,9326
10117,marchagaz,caceres,40,26,42,112,256,476
10118,mata,caceres,50,40,52,120,318,580
10119,membrio,caceres,100,58,134,248,616,1156
10120,mesas,caceres,12,14,26,54,202,308
10121,miajadas,caceres,2970,1478,2066,5170,7052,18736
10122,millanes,caceres,44,26,44,94,244,452
10123,mirabel,caceres,124,70,98,318,656,1266
10124,mohedas,caceres,214,94,152,428,836,1724
10125,monroy,caceres,188,98,156,484,842,1768
10126,montanchez,caceres,394,152,286,810,1602,3244
10127,montehermoso,caceres,1842,804,1096,3102,4354,11198
10128,moraleja,caceres,1920,868,1190,3812,5364,13154
10129,morcillo,caceres,52,44,74,198,370,738
10130,navaconcejo,caceres,596,264,410,1088,1732,4090
10131,navalmoral,caceres,6352,2696,3566,9812,11660,34086
10132,navalvillar,caceres,68,40,64,192,396,760
10133,navas,caceres,298,148,256,632,1184,2518
10134,navezuelas,caceres,164,86,136,284,628,1298
10135,nunomoral,caceres,246,96,148,624,1290,2404
10136,oliva,caceres,60,14,62,158,290,584
10137,palomero,caceres,106,52,88,208,450,904
10138,pasaron,caceres,124,74,120,314,556,1188
10139,pedroso,caceres,6,14,22,58,106,206
10140,peraleda,caceres,490,182,228,818,1140,2858
10141,peraleda,caceres,54,42,28,102,332,558
10142,perales,caceres,200,106,192,470,844,1812
10143,pescueza,caceres,34,4,14,56,188,296
10144,"pesga,",caceres,198,76,126,442,1068,1910
10145,piedras,caceres,12,28,16,48,144,248
10146,pinofranqueado,caceres,526,236,304,1032,1444,3542
10147,piornal,caceres,346,222,292,816,1230,2906
10148,plasencia,caceres,12916,6134,8014,22984,30056,80104
10149,plasenzuela,caceres,106,84,108,188,558,1044
10150,portaje,caceres,68,52,64,152,416,752
10151,portezuelo,caceres,44,8,44,114,204,414
10152,pozuelo,caceres,92,42,52,202,468,856
10153,puerto,caceres,44,30,52,122,280,528
10154,rebollar,caceres,44,32,28,122,166,392
10155,riolobos,caceres,234,144,214,640,1122,2354
10156,robledillo,caceres,14,4,10,56,104,188
10157,robledillo,caceres,38,34,44,120,284,520
10158,robledillo,caceres,54,52,62,190,376,734
10159,robledollano,caceres,36,34,58,130,384,642
10160,romangordo,caceres,48,26,50,96,282,502
10161,ruanes,caceres,14,12,18,38,82,164
10162,salorino,caceres,82,44,108,254,588,1076
10163,salvatierra,caceres,26,10,34,82,342,494
10164,san,caceres,94,84,112,292,828,1410
10165,santa,caceres,30,26,72,110,374,612
10166,santa,caceres,78,52,56,178,284,648
10167,santa,caceres,34,30,56,126,332,578
10168,santa,caceres,26,18,34,106,398,582
10169,santiago,caceres,42,52,70,174,586,924
10170,santiago,caceres,38,18,44,120,278,498
10171,santibanez,caceres,68,42,60,226,374,770
10172,santibanez,caceres,118,84,146,324,752,1424
10173,saucedilla,caceres,402,206,260,540,564,1972
10174,segura,caceres,32,22,32,106,170,362
10175,serradilla,caceres,366,160,298,758,1422,3004
10176,serrejon,caceres,116,38,78,212,376,820
10177,sierra,caceres,560,244,494,1220,1604,4122
10178,talavan,caceres,202,54,144,358,784,1542
10179,talaveruela,caceres,44,28,34,170,326,602
10180,talayuela,caceres,3046,1360,1682,4210,4250,14548
10181,tejeda,caceres,158,120,126,356,770,1530
10182,toril,caceres,46,26,38,98,108,316
10183,tornavacas,caceres,248,128,180,518,962,2036
10184,"torno,",caceres,168,80,136,406,864,1654
10185,torrecilla,caceres,140,66,110,282,684,1282
10186,torrecillas,caceres,262,112,246,528,948,2096
10187,torre,caceres,128,52,80,266,426,952
10188,torre,caceres,72,62,104,230,570,1038
10189,torrejoncillo,caceres,740,384,544,1456,2418,5542
10190,torrejon,caceres,96,48,106,284,544,1078
10191,torremenga,caceres,158,86,128,328,534,1234
10192,torremocha,caceres,112,64,112,310,900,1498
10193,torreorgaz,caceres,508,226,398,914,1300,3346
10194,torrequemada,caceres,108,64,90,260,604,1126
10195,trujillo,caceres,2394,1296,1630,4832,7184,17336
10196,valdastillas,caceres,54,28,54,164,342,642
10197,valdecanas,caceres,16,4,16,46,114,196
10198,valdefuentes,caceres,218,124,220,498,1150,2210
10199,valdehuncar,caceres,40,22,38,116,158,374
10200,valdelacasa,caceres,30,22,48,148,434,682
10201,valdemorales,caceres,34,18,64,100,214,430
10202,valdeobispo,caceres,106,80,96,300,638,1220
10203,valencia,caceres,1320,658,860,2868,4668,10374
10204,valverde,caceres,80,48,54,214,500,896
10205,valverde,caceres,466,252,372,1106,2088,4284
10206,viandar,caceres,48,14,28,122,224,436
10207,villa,caceres,54,32,96,198,510,890
10208,villa,caceres,14,10,20,58,130,232
10209,villamesias,caceres,28,24,62,112,326,552
10210,villamiel,caceres,26,50,102,166,508,852
10211,villanueva,caceres,126,68,76,220,502,992
10212,villanueva,caceres,580,266,338,1234,1806,4224
10213,villar,caceres,82,44,120,220,646,1112
10214,villar,caceres,20,26,34,94,290,464
10215,villasbuenas,caceres,78,38,126,252,524,1018
10216,zarza,caceres,510,240,370,962,1528,3610
10217,zarza,caceres,64,72,86,230,584,1036
10218,zarza,caceres,246,118,240,508,1142,2254
10219,zorita,caceres,252,122,196,582,1346,2498
10901,rosalejo,caceres,404,172,284,768,1066,2694
10902,vegaviana,caceres,262,112,148,464,714,1700
10903,alagon,caceres,266,90,174,542,748,1820
10904,tietar,caceres,272,102,140,536,666,1716
10905,pueblonuevo,caceres,246,118,154,376,648,1542
11001,alcala,cadiz,1586,890,1340,3128,3518,10462
11002,alcala,cadiz,1490,728,1098,2874,3674,9864
11003,algar,cadiz,462,208,296,852,1072,2890
11004,algeciras,cadiz,48622,20468,27616,77556,75832,250094
11005,algodonales,cadiz,1570,808,1148,3092,4256,10874
11006,arcos,cadiz,10590,5230,6800,19426,20064,62110
11007,barbate,cadiz,7440,3594,5144,13586,15686,45450
11008,"barrios,",cadiz,9660,4024,5408,15918,14070,49080
11009,benaocaz,cadiz,190,94,176,482,580,1522
11010,bornos,cadiz,2332,1182,1696,4576,5278,15064
11011,"bosque,",cadiz,762,336,510,1388,1502,4498
11012,cadiz,cadiz,29312,15192,20982,62966,93908,222360
11013,castellar,cadiz,1080,450,732,1774,1944,5980
11014,conil,cadiz,9054,3312,5160,15770,14788,48084
11015,chiclana,cadiz,34008,14714,19292,57662,53934,179610
11016,chipiona,cadiz,7146,3074,4550,12116,12944,39830
11017,espera,cadiz,1192,570,778,2388,2624,7552
11018,"gastor,",cadiz,460,224,348,1034,1346,3412
11019,grazalema,cadiz,512,274,418,1202,1608,4014
11020,jerez,cadiz,76512,36094,44652,129678,142752,429688
11021,jimena,cadiz,2498,1052,1444,4016,4566,13576
11022,linea,cadiz,23848,9866,16016,39742,40502,129974
11023,medina,cadiz,4132,1776,2476,7482,7746,23612
11024,olvera,cadiz,2428,1188,1636,4164,6282,15698
11025,paterna,cadiz,1932,920,1260,3582,3338,11032
11026,prado,cadiz,1734,840,1268,3494,4068,11404
11027,puerto,cadiz,32710,15112,18732,54706,59586,180846
11028,puerto,cadiz,14256,6704,8734,26872,27624,84190
11029,puerto,cadiz,2640,1326,1936,4164,3716,13782
11030,rota,cadiz,10414,4394,6642,18562,19908,59920
11031,san,cadiz,31996,15010,19044,56348,65188,187586
11032,sanlucar,cadiz,26156,10104,15580,42406,45528,139774
11033,san,cadiz,13500,5544,7834,22274,20082,69234
11034,setenil,cadiz,758,418,624,1522,1950,5272
11035,tarifa,cadiz,5966,2522,4042,12660,12124,37314
11036,torre,cadiz,232,110,146,438,674,1600
11037,trebujena,cadiz,2494,1056,1452,4290,4810,14102
11038,ubrique,cadiz,5378,2328,3140,9948,12088,32882
11039,vejer,cadiz,4360,1926,2730,8202,8864,26082
11040,villaluenga,cadiz,146,62,110,254,362,934
11041,villamartin,cadiz,4266,2064,2868,7372,7928,24498
11042,zahara,cadiz,328,224,268,776,1124,2720
11901,benalup-casas,cadiz,2442,1240,1718,4530,4614,14544
11902,san,cadiz,1458,664,1042,2702,3072,8938
11903,san,cadiz,998,404,656,1748,1702,5508
12001,atzeneta,castellon/castello,358,128,266,706,1160,2618
12002,ain,castellon/castello,20,10,24,68,142,264
12003,albocàsser,castellon/castello,408,144,298,698,1114,2662
12004,alcalà,castellon/castello,2308,976,1490,4246,5618,14638
12005,"alcora,",castellon/castello,3490,1638,2136,6448,7460,21172
12006,alcudia,castellon/castello,28,26,76,86,210,426
12007,alfondeguilla,castellon/castello,226,114,176,466,758,1740
12008,algimia,castellon/castello,20,24,54,136,280,514
12009,almassora,castellon/castello,11282,4090,6382,19328,15798,56880
12010,almedijar,castellon/castello,58,24,82,138,272,574
12011,almenara,castellon/castello,2226,874,1440,4450,4454,13444
12012,altura,castellon/castello,1370,528,844,2272,2666,7680
12013,aranuel,castellon/castello,18,10,32,82,176,318
12014,ares,castellon/castello,22,22,22,108,182,356
12015,argelita,castellon/castello,26,18,56,76,120,296
12016,artana,castellon/castello,616,260,372,1060,1626,3934
12017,ayodar,castellon/castello,14,28,26,94,202,364
12018,azuebar,castellon/castello,90,44,82,170,318,704
12020,barracas,castellon/castello,68,18,52,114,146,398
12021,betxi,castellon/castello,1746,868,1154,3362,4138,11268
12022,bejis,castellon/castello,76,62,76,216,364,794
12024,benafer,castellon/castello,38,22,58,84,142,344
12025,benafigos,castellon/castello,8,14,14,68,154,258
12026,benassal,castellon/castello,262,144,240,526,936,2108
12027,benicarlo,castellon/castello,10828,4606,7082,17598,19388,59502
12028,benicàssim/benicasim,castellon/castello,6912,2876,3782,12888,14216,40674
12029,benlloc,castellon/castello,380,172,254,646,794,2246
12031,borriol,castellon/castello,2268,894,1184,3870,3672,11888
12032,borriana/burriana,castellon/castello,13310,6130,7796,22628,23444,73308
12033,cabanes,castellon/castello,1086,406,726,1930,2482,6630
12034,càlig,castellon/castello,690,264,422,1158,1584,4118
12036,canet,castellon/castello,154,68,130,342,702,1396
12037,castell,castellon/castello,4,2,10,12,16,44
12038,castellfort,castellon/castello,46,20,34,110,168,378
12039,castellnovo,castellon/castello,188,104,180,426,874,1772
12040,castello,castellon/castello,61460,27966,40006,109532,120758,359722
12041,castillo,castellon/castello,10,18,26,52,128,234
12042,cati,castellon/castello,206,78,154,408,676,1522
12043,caudiel,castellon/castello,148,96,118,412,668,1442
12044,cervera,castellon/castello,110,52,108,292,740,1302
12045,cinctorres,castellon/castello,152,34,98,230,368,882
12046,cirat,castellon/castello,16,18,52,112,230,428
12048,cortes,castellon/castello,82,46,54,190,254,626
12049,costur,castellon/castello,142,84,76,370,398,1070
12050,coves,castellon/castello,634,214,374,1030,1444,3696
12051,culla,castellon/castello,76,68,94,232,516,986
12052,xert,castellon/castello,114,110,144,336,668,1372
12053,chilches/xilxes,castellon/castello,962,450,728,1902,2124,6166
12055,xodos/chodos,castellon/castello,22,16,26,60,108,232
12056,chovar,castellon/castello,56,36,86,128,318,624
12057,eslida,castellon/castello,226,90,144,494,618,1572
12058,espadilla,castellon/castello,22,14,18,58,68,180
12059,fanzara,castellon/castello,62,62,48,134,290,596
12060,figueroles,castellon/castello,134,64,102,290,444,1034
12061,forcall,castellon/castello,138,50,82,232,452,954
12063,fuente,castellon/castello,8,6,22,36,48,120
12064,fuentes,castellon/castello,10,8,26,44,102,190
12065,gaibiel,castellon/castello,20,26,44,104,202,396
12067,geldo,castellon/castello,184,86,134,370,524,1298
12068,herbers,castellon/castello,10,2,4,46,76,138
12069,higueras,castellon/castello,0,10,10,24,48,92
12070,"jana,",castellon/castello,214,86,116,350,608,1374
12071,jerica,castellon/castello,514,228,322,1014,1376,3454
12072,llucena/lucena,castellon/castello,352,196,274,804,1206,2832
12073,ludiente,castellon/castello,42,18,32,104,154,350
12074,"llosa,",castellon/castello,330,168,196,684,698,2076
12075,mata,castellon/castello,64,28,56,106,118,372
12076,matet,castellon/castello,16,4,8,56,98,182
12077,moncofa,castellon/castello,2492,920,1828,5198,5450,15888
12078,montan,castellon/castello,84,46,60,194,458,842
12079,montanejos,castellon/castello,182,98,138,402,444,1264
12080,morella,castellon/castello,714,288,540,1378,2064,4984
12081,navajas,castellon/castello,222,110,150,496,750,1728
12082,nules,castellon/castello,5298,2198,2854,8580,9292,28222
12083,olocau,castellon/castello,44,28,34,58,108,272
12084,onda,castellon/castello,9592,3888,5576,16432,16138,51626
12085,orpesa/oropesa,castellon/castello,4084,1482,2466,7470,7686,23188
12087,palanques,castellon/castello,6,16,8,16,22,68
12088,pavias,castellon/castello,12,6,16,36,78,148
12089,peniscola/peniscola,castellon/castello,2738,980,1640,5144,6416,16918
12090,pina,castellon/castello,18,16,16,72,118,240
12091,portell,castellon/castello,18,10,24,60,202,314
12092,puebla,castellon/castello,36,16,26,92,178,348
12093,pobla,castellon/castello,60,30,40,140,210,480
12094,pobla,castellon/castello,536,202,246,894,788,2666
12095,ribesalbes,castellon/castello,324,180,224,620,988,2336
12096,rossell,castellon/castello,200,140,170,464,826,1800
12097,sacanet,castellon/castello,6,8,6,44,90,154
12098,"salzadella,",castellon/castello,188,82,116,328,644,1358
12099,sant,castellon/castello,330,130,212,866,1280,2818
12100,sant,castellon/castello,746,246,372,1186,1434,3984
12101,san,castellon/castello,172,72,80,302,436,1062
12102,santa,castellon/castello,244,86,146,448,616,1540
12103,"serratella,",castellon/castello,12,20,16,70,110,228
12104,segorbe,castellon/castello,3272,1416,2026,5652,6896,19262
12105,sierra,castellon/castello,260,112,222,544,944,2082
12106,soneja,castellon/castello,470,200,280,850,1232,3032
12107,sot,castellon/castello,122,90,114,250,420,996
12108,suera/sueras,castellon/castello,182,72,116,348,444,1162
12109,tales,castellon/castello,280,104,154,558,582,1678
12110,teresa,castellon/castello,30,34,46,114,238,462
12111,tirig,castellon/castello,100,38,84,226,408,856
12112,todolella,castellon/castello,50,18,50,66,118,302
12113,toga,castellon/castello,18,20,28,48,104,218
12114,toras,castellon/castello,44,12,64,152,268,540
12115,"toro,",castellon/castello,42,24,56,130,272,524
12116,torralba,castellon/castello,2,12,14,28,60,116
12117,torreblanca,castellon/castello,1800,768,1252,3292,4272,11384
12118,torrechiva,castellon/castello,42,14,38,50,92,236
12119,torre,castellon/castello,36,12,42,76,158,324
12120,torre,castellon/castello,34,20,42,80,188,364
12121,traiguera,castellon/castello,342,164,188,700,1222,2616
12122,"useres,",castellon/castello,214,62,176,566,912,1930
12123,vallat,castellon/castello,4,20,24,50,46,144
12124,vall,castellon/castello,1070,386,638,1992,2090,6176
12125,vall,castellon/castello,46,40,52,140,278,556
12126,vall,castellon/castello,10808,4748,6432,19098,22602,63688
12127,vallibona,castellon/castello,4,10,6,38,70,128
12128,vilafames,castellon/castello,638,320,412,1224,1266,3860
12129,vilafranca/villafranca,castellon/castello,572,280,434,1008,1978,4272
12130,villahermosa,castellon/castello,92,38,82,220,554,986
12131,villamalur,castellon/castello,6,10,22,54,102,194
12132,vilanova,castellon/castello,132,80,134,304,550,1200
12133,villanueva,castellon/castello,6,16,28,50,96,196
12134,vilar,castellon/castello,34,40,24,92,122,312
12135,vila-real,castellon/castello,19602,8504,11406,32300,33234,105046
12136,"vilavella,",castellon/castello,876,500,576,1722,2474,6148
12137,villores,castellon/castello,0,12,22,28,44,106
12138,vinaròs,castellon/castello,10308,4532,6214,17956,21508,60518
12139,vistabella,castellon/castello,58,52,68,198,356,732
12140,viver,castellon/castello,504,188,346,992,1326,3356
12141,zorita,castellon/castello,22,22,26,42,112,224
12142,zucaina,castellon/castello,22,26,40,86,174,348
12901,"alqueries,",castellon/castello,1654,654,818,2994,2952,9072
12902,sant,castellon/castello,1526,478,822,2558,1946,7330
13001,abenojar,ciudad,298,146,284,590,1328,2646
13002,agudo,ciudad,440,172,382,682,1522,3198
13003,alamillo,ciudad,52,40,122,162,546,922
13004,albaladejo,ciudad,178,98,214,450,1086,2026
13005,alcazar,ciudad,10990,4840,6760,19342,20846,62778
13006,alcoba,ciudad,114,42,124,322,554,1156
13007,alcolea,ciudad,304,194,350,672,1200,2720
13008,alcubillas,ciudad,48,54,92,158,484,836
13009,aldea,ciudad,328,162,376,770,1522,3158
13010,alhambra,ciudad,244,94,220,490,890,1938
13011,almaden,ciudad,1228,750,1020,2342,4452,9792
13012,almadenejos,ciudad,70,66,70,196,386,788
13013,almagro,ciudad,3098,1424,2262,5180,6200,18164
13014,almedina,ciudad,80,68,76,232,508,964
13015,almodovar,ciudad,1334,698,1062,2804,5498,11396
13016,almuradiel,ciudad,194,60,180,388,688,1510
13017,anchuras,ciudad,68,24,42,116,296,546
13018,arenas,ciudad,362,120,200,580,780,2042
13019,argamasilla,ciudad,2234,1088,1612,4066,4690,13690
13020,argamasilla,ciudad,1980,740,1064,3550,4300,11634
13021,arroba,ciudad,42,36,74,164,496,812
13022,ballesteros,ciudad,56,40,78,202,346,722
13023,bolanos,ciudad,4118,1828,3260,7192,7664,24062
13024,brazatortas,ciudad,228,102,238,488,940,1996
13025,cabezarados,ciudad,64,30,50,138,324,606
13026,cabezarrubias,ciudad,88,46,90,238,524,986
13027,calzada,ciudad,982,536,794,1926,3246,7484
13028,campo,ciudad,4290,1906,2840,7240,9602,25878
13029,canada,ciudad,16,12,20,52,106,206
13030,caracuel,ciudad,32,8,18,84,124,266
13031,carrion,ciudad,1124,402,730,2068,2142,6466
13032,carrizosa,ciudad,176,166,224,474,1166,2206
13033,castellar,ciudad,394,276,384,936,1536,3526
13034,ciudad,ciudad,25684,11746,17354,43858,52706,151348
13035,corral,ciudad,348,124,218,624,968,2282
13036,"cortijos,",ciudad,188,110,152,422,822,1694
13037,cozar,ciudad,188,112,200,422,886,1808
13038,chillon,ciudad,414,216,322,878,1716,3546
13039,daimiel,ciudad,5728,2516,4142,10072,12906,35364
13040,fernan,ciudad,238,128,168,542,852,1928
13041,fontanarejo,ciudad,28,26,36,132,244,466
13042,fuencaliente,ciudad,282,122,218,468,912,2002
13043,fuenllana,ciudad,8,22,34,86,258,408
13044,fuente,ciudad,892,422,686,1592,2504,6096
13045,granatula,ciudad,146,94,140,320,668,1368
13046,guadalmez,ciudad,142,80,110,374,714,1420
13047,herencia,ciudad,3092,1528,2030,4852,5398,16900
13048,hinojosas,ciudad,106,34,90,232,560,1022
13049,horcajo,ciudad,192,88,142,398,786,1606
13050,"labores,",ciudad,106,84,112,260,534,1096
13051,luciana,ciudad,60,48,56,170,384,718
13052,malagon,ciudad,2588,1052,1826,4286,5826,15578
13053,manzanares,ciudad,5956,2566,3570,10294,13002,35388
13054,membrilla,ciudad,1852,820,1266,3032,4700,11670
13055,mestanza,ciudad,76,62,134,296,744,1312
13056,miguelturra,ciudad,6416,2568,3322,10676,8600,31582
13057,montiel,ciudad,268,170,278,556,1116,2388
13058,moral,ciudad,1736,794,1170,2804,3692,10196
13059,navalpino,ciudad,36,16,36,68,240,396
13060,navas,ciudad,38,28,34,116,346,562
13061,pedro,ciudad,2572,1244,1728,4394,5448,15386
13062,picon,ciudad,230,84,140,422,512,1388
13063,piedrabuena,ciudad,1304,630,1024,2322,3420,8700
13064,poblete,ciudad,1552,338,562,2278,1166,5896
13065,porzuna,ciudad,1078,502,760,1854,2852,7046
13066,pozuelo,ciudad,1538,612,1090,2468,2188,7896
13067,pozuelos,ciudad,38,40,70,192,364,704
13068,puebla,ciudad,312,118,278,596,980,2284
13069,puebla,ciudad,98,72,118,328,678,1294
13070,puerto,ciudad,236,132,182,452,732,1734
13071,puertollano,ciudad,14754,6272,8816,25776,35058,90676
13072,retuerta,ciudad,218,146,166,512,734,1776
13073,saceruela,ciudad,96,54,76,240,570,1036
13074,san,ciudad,350,130,224,570,866,2140
13075,san,ciudad,24,16,40,82,234,396
13076,santa,ciudad,104,54,84,242,458,942
13077,santa,ciudad,1020,552,826,2004,3328,7730
13078,socuellamos,ciudad,4138,1994,2730,7052,8424,24338
13079,"solana,",ciudad,5084,2574,3802,8624,10326,30410
13080,solana,ciudad,16,24,50,140,440,670
13081,terrinches,ciudad,122,76,158,274,556,1186
13082,tomelloso,ciudad,13314,5752,9110,22348,22916,73440
13083,torralba,ciudad,1056,360,654,1800,2292,6162
13084,torre,ciudad,210,140,180,412,946,1888
13085,torrenueva,ciudad,868,348,640,1336,2144,5336
13086,valdemanco,ciudad,12,14,42,48,208,324
13087,valdepenas,ciudad,10418,4726,6796,17894,21260,61094
13088,valenzuela,ciudad,184,68,160,338,560,1310
13089,villahermosa,ciudad,336,242,342,754,1752,3426
13090,villamanrique,ciudad,224,138,232,516,1040,2150
13091,villamayor,ciudad,144,84,106,292,614,1240
13092,villanueva,ciudad,422,266,442,882,1754,3766
13093,villanueva,ciudad,1198,724,1090,2274,4230,9516
13094,villanueva,ciudad,10,18,66,110,344,548
13095,villar,ciudad,0,0,4,22,68,94
13096,villarrubia,ciudad,3224,1450,2230,5502,6970,19376
13097,villarta,ciudad,850,362,594,1344,2244,5394
13098,viso,ciudad,468,284,410,956,2064,4182
13901,"robledo,",ciudad,272,146,262,516,916,2112
13902,ruidera,ciudad,138,72,98,310,448,1066
13903,arenales,ciudad,156,100,104,308,564,1232
13904,llanos,ciudad,232,108,178,400,430,1348
14001,adamuz,cordoba,1370,492,836,2346,3132,8176
14002,aguilar,cordoba,4348,1906,3038,7562,9516,26370
14003,alcaracejos,cordoba,402,188,324,806,1284,3004
14004,almedinilla,cordoba,696,294,660,1232,1768,4650
14005,almodovar,cordoba,3040,1274,1766,4400,5482,15962
14006,anora,cordoba,470,196,330,788,1230,3014
14007,baena,cordoba,6520,2924,4468,10120,12688,36720
14008,belalcazar,cordoba,834,460,722,1572,2604,6192
14009,belmez,cordoba,732,388,606,1368,2600,5694
14010,benameji,cordoba,1706,830,1148,2702,3434,9820
14011,"blazquez,",cordoba,156,128,118,340,528,1270
14012,bujalance,cordoba,2326,1088,1678,3872,5326,14290
14013,cabra,cordoba,6160,3146,4528,10978,15220,40032
14014,canete,cordoba,764,344,650,1360,2476,5594
14015,carcabuey,cordoba,586,356,546,1122,2006,4616
14016,cardena,cordoba,338,168,322,676,1346,2850
14017,"carlota,",cordoba,5544,2174,3162,8772,9102,28754
14018,"carpio,",cordoba,1458,616,858,2570,3144,8646
14019,castro,cordoba,2414,1166,1696,4182,5770,15228
14020,conquista,cordoba,52,32,84,150,424,742
14021,cordoba,cordoba,109666,50238,69882,188286,231732,649804
14022,dona,cordoba,1326,704,1042,2448,3436,8956
14023,dos,cordoba,786,330,576,1152,1914,4758
14024,encinas,cordoba,710,342,510,1226,1688,4476
14025,espejo,cordoba,826,384,704,1642,2800,6356
14026,espiel,cordoba,676,288,402,1336,1974,4676
14027,fernan-nunez,cordoba,3296,1400,2170,5538,6866,19270
14028,fuente,cordoba,84,42,72,192,286,676
14029,fuente,cordoba,940,574,904,2178,4118,8714
14030,fuente,cordoba,3848,1558,2402,5686,6508,20002
14031,fuente-tojar,cordoba,184,90,144,328,606,1352
14032,"granjuela,",cordoba,86,64,76,192,406,824
14033,guadalcazar,cordoba,590,186,396,996,930,3098
14034,"guijo,",cordoba,92,42,74,164,316,688
14035,hinojosa,cordoba,1854,830,1442,3306,5654,13086
14036,hornachuelos,cordoba,1392,648,994,2402,3340,8776
14037,iznajar,cordoba,834,530,784,1748,3588,7484
14038,lucena,cordoba,16444,7140,10396,26054,26046,86080
14039,luque,cordoba,694,446,714,1302,2478,5634
14040,montalban,cordoba,1420,620,838,2550,3442,8870
14041,montemayor,cordoba,1216,610,886,2154,2926,7792
14042,montilla,cordoba,6818,3410,5106,12342,16954,44630
14043,montoro,cordoba,3126,1490,2050,5172,6230,18068
14044,monturque,cordoba,626,330,426,1092,1396,3870
14045,moriles,cordoba,1236,594,892,1962,2596,7280
14046,nueva,cordoba,1722,774,1224,3066,3838,10624
14047,obejo,cordoba,662,318,568,1348,1284,4180
14048,palenciana,cordoba,446,248,308,802,1060,2864
14049,palma,cordoba,6994,3296,4718,12106,14096,41210
14050,pedro,cordoba,880,434,626,1628,2082,5650
14051,pedroche,cordoba,316,174,324,670,1428,2912
14052,penarroya-pueblonuevo,cordoba,2810,1410,2144,5384,8812,20560
14053,posadas,cordoba,2468,1096,1620,3914,5346,14444
14054,pozoblanco,cordoba,5682,2570,3896,9318,12350,33816
14055,priego,cordoba,6860,3342,4878,11758,16864,43702
14056,puente,cordoba,10806,4774,7380,16590,20208,59758
14057,"rambla,",cordoba,2418,1114,1674,4432,5294,14932
14058,rute,cordoba,3166,1504,2174,5340,7322,19506
14059,san,cordoba,266,116,192,454,680,1708
14060,santaella,cordoba,1772,704,1008,2710,3164,9358
14061,santa,cordoba,88,84,124,286,838,1420
14062,torrecampo,cordoba,182,102,208,452,1056,2000
14063,valenzuela,cordoba,196,100,262,492,1032,2082
14064,valsequillo,cordoba,82,58,84,150,348,722
14065,"victoria,",cordoba,872,342,456,1422,1564,4656
14066,villa,cordoba,2352,1120,1536,3852,4884,13744
14067,villafranca,cordoba,1886,680,1026,3154,3004,9750
14068,villaharta,cordoba,120,76,146,324,586,1252
14069,villanueva,cordoba,2396,1186,1856,4500,6804,16742
14070,villanueva,cordoba,320,144,308,646,1394,2812
14071,villanueva,cordoba,286,126,172,512,930,2026
14072,villaralto,cordoba,242,88,188,532,1100,2150
14073,villaviciosa,cordoba,786,404,568,1666,2696,6120
14074,"viso,",cordoba,656,334,616,1156,2260,5022
14075,zuheros,cordoba,118,88,100,316,590,1212
14901,fuente,cordoba,318,186,248,564,814,2130
14902,"guijarrosa,",cordoba,464,154,312,790,998,2718
15001,abegondo,"coruna,",1394,606,798,3274,5082,11154
15002,ames,"coruna,",11948,4838,6412,23298,19102,65598
15003,aranga,"coruna,",310,96,230,930,2032,3598
15004,ares,"coruna,",1568,704,992,3694,5362,12320
15005,arteixo,"coruna,",11454,4580,6786,23574,21622,68016
15006,arzua,"coruna,",1398,606,930,3084,5766,11784
15007,"bana,","coruna,",632,258,470,1626,3612,6598
15008,bergondo,"coruna,",1798,852,964,3982,6358,13954
15009,betanzos,"coruna,",3698,1648,2364,8128,10612,26450
15010,boimorto,"coruna,",254,146,300,830,2070,3600
15011,boiro,"coruna,",5562,2602,3656,11970,14206,37996
15012,boqueixon,"coruna,",1184,438,806,2464,3528,8420
15013,brion,"coruna,",2818,1014,1336,5554,5634,16356
15014,cabana,"coruna,",804,368,638,1974,4414,8198
15015,cabanas,"coruna,",668,330,486,1776,3334,6594
15016,camarinas,"coruna,",1114,546,912,2552,5064,10188
15017,cambre,"coruna,",7398,3676,4446,15902,18146,49568
15018,"capela,","coruna,",228,124,146,692,1170,2360
15019,carballo,"coruna,",9498,3808,5572,19296,24972,63146
15020,carnota,"coruna,",676,326,470,1926,4220,7618
15021,carral,"coruna,",2072,848,1244,4446,4940,13550
15022,cedeira,"coruna,",1544,744,1090,3682,6030,13090
15023,cee,"coruna,",2138,900,1380,4482,6566,15466
15024,cerceda,"coruna,",1336,458,790,3074,4486,10144
15025,cerdido,"coruna,",184,68,136,538,1080,2006
15027,coiros,"coruna,",574,148,270,1136,1734,3862
15028,corcubion,"coruna,",362,196,362,848,1598,3366
15029,coristanco,"coruna,",1228,546,832,2806,6062,11474
15030,"coruna,","coruna,",69286,31114,51754,150536,195820,498510
15031,culleredo,"coruna,",10386,4374,5676,20162,21496,62094
15032,curtis,"coruna,",1120,456,838,2326,3588,8328
15033,dodro,"coruna,",630,284,386,1444,2508,5252
15034,dumbria,"coruna,",524,240,534,1460,2848,5606
15035,fene,"coruna,",2948,1320,1896,7270,11624,25058
15036,ferrol,"coruna,",15798,8290,11684,34890,58054,128716
15037,fisterra,"coruna,",1042,576,836,2700,4302,9456
15038,frades,"coruna,",426,158,398,1118,2274,4374
15039,irixoa,"coruna,",238,122,190,728,1388,2666
15040,laxe,"coruna,",628,302,446,1536,2928,5840
15041,"laracha,","coruna,",3358,1168,1904,7232,9544,23206
15042,lousame,"coruna,",704,320,480,1714,3010,6228
15043,malpica,"coruna,",852,478,854,2756,5626,10566
15044,manon,"coruna,",186,70,196,580,1414,2446
15045,mazaricos,"coruna,",670,318,648,1776,4050,7462
15046,melide,"coruna,",2178,944,1490,4452,6436,15500
15047,mesia,"coruna,",482,212,360,1226,2474,4754
15048,mino,"coruna,",2164,750,1112,4786,5072,13884
15049,moeche,"coruna,",226,94,182,642,1260,2404
15050,monfero,"coruna,",344,128,268,942,1946,3628
15051,mugardos,"coruna,",1220,536,754,3084,4782,10376
15052,muxia,"coruna,",826,440,722,2240,4534,8762
15053,muros,"coruna,",1722,918,1298,4126,8288,16352
15054,naron,"coruna,",12450,4892,6586,26378,28334,78640
15055,neda,"coruna,",1078,498,710,2848,4618,9752
15056,negreira,"coruna,",2034,844,1236,4336,5434,13884
15057,noia,"coruna,",3676,1786,2436,8162,12078,28138
15058,oleiros,"coruna,",13302,5206,6352,23708,28040,76608
15059,ordes,"coruna,",3884,1562,2164,8040,9874,25524
15060,oroso,"coruna,",2652,1058,1604,5156,4994,15464
15061,ortigueira,"coruna,",916,522,786,2724,5948,10896
15062,outes,"coruna,",1214,530,846,3204,6316,12110
15064,paderne,"coruna,",530,238,320,1296,2398,4782
15065,padron,"coruna,",2326,1088,1392,5026,6752,16584
15066,"pino,","coruna,",1186,454,856,2628,4032,9156
15067,pobra,"coruna,",2340,1238,1752,5214,7818,18362
15068,ponteceso,"coruna,",1120,498,728,2840,5420,10606
15069,pontedeume,"coruna,",1894,840,1168,4088,6920,14910
15070,pontes,"coruna,",2464,882,1424,5852,8932,19554
15071,porto,"coruna,",2372,1134,1604,5014,8036,18160
15072,rianxo,"coruna,",2844,1260,1948,6322,9144,21518
15073,ribeira,"coruna,",8270,3740,5674,16072,20304,54060
15074,rois,"coruna,",1180,436,676,2596,3896,8784
15075,sada,"coruna,",5092,2070,2724,10656,13844,34386
15076,san,"coruna,",594,230,348,1522,2792,5486
15077,santa,"coruna,",2338,1004,1626,5130,8494,18592
15078,santiago,"coruna,",29100,12740,21174,60050,75918,198982
15079,santiso,"coruna,",196,110,244,656,1702,2908
15080,sobrado,"coruna,",272,142,316,794,1986,3510
15081,"somozas,","coruna,",216,118,154,640,1012,2140
15082,teo,"coruna,",5956,2652,3400,12160,14098,38266
15083,toques,"coruna,",144,102,188,484,1226,2144
15084,tordoia,"coruna,",562,228,522,1510,3576,6398
15085,touro,"coruna,",692,304,586,1568,3648,6798
15086,trazo,"coruna,",690,260,468,1550,3018,5986
15087,valdovino,"coruna,",1604,670,866,3938,6640,13718
15088,val,"coruna,",878,328,616,1962,3718,7502
15089,vedra,"coruna,",1306,488,808,3032,4244,9878
15090,vilasantar,"coruna,",214,88,192,608,1362,2464
15091,vilarmaior,"coruna,",258,102,186,726,1232,2504
15092,vimianzo,"coruna,",1450,648,1230,3572,6698,13598
15093,zas,"coruna,",766,480,644,2042,4592,8524
15901,carino,"coruna,",708,380,522,1908,3866,7384
15902,oza-cesuras,"coruna,",1050,452,744,3020,5030,10296
16001,abia,cuenca,0,4,14,30,70,118
16002,"acebron,",cuenca,50,30,52,112,218,462
16003,alarcon,cuenca,34,12,46,94,164,350
16004,albaladejo,cuenca,14,14,24,74,308,434
16005,albalate,cuenca,44,26,40,126,306,542
16006,albendea,cuenca,18,10,10,76,144,258
16007,alberca,cuenca,438,244,338,852,1218,3090
16008,alcala,cuenca,4,6,22,22,92,146
16009,alcantud,cuenca,8,2,6,20,82,118
16010,alcazar,cuenca,26,22,24,90,174,336
16011,alcohujate,cuenca,4,0,6,16,28,54
16012,alconchel,cuenca,8,20,10,28,92,158
16013,algarra,cuenca,10,0,0,8,32,50
16014,aliaguilla,cuenca,136,66,114,296,608,1220
16015,"almarcha,",cuenca,64,58,76,194,468,860
16016,almendros,cuenca,34,20,38,112,276,480
16017,almodovar,cuenca,96,50,80,204,370,800
16018,almonacid,cuenca,76,50,78,216,418,838
16019,altarejos,cuenca,22,40,26,90,234,412
16020,arandilla,cuenca,4,0,0,12,12,28
16022,arcos,cuenca,20,8,10,30,106,174
16023,chillaron,cuenca,308,156,196,564,548,1772
16024,arguisuelas,cuenca,22,22,16,64,136,260
16025,arrancacepas,cuenca,0,0,0,12,20,32
16026,atalaya,cuenca,4,8,28,46,110,196
16027,barajas,cuenca,236,130,180,654,764,1964
16029,barchin,cuenca,2,8,16,62,120,208
16030,bascunana,cuenca,0,0,2,24,22,48
16031,beamud,cuenca,4,0,8,24,62,98
16032,belinchon,cuenca,124,62,86,238,372,882
16033,belmonte,cuenca,350,192,394,804,1830,3570
16034,belmontejo,cuenca,4,6,22,52,174,258
16035,beteta,cuenca,32,24,60,82,282,480
16036,boniches,cuenca,54,20,14,80,102,270
16038,buciegas,cuenca,4,4,4,22,42,76
16039,buenache,cuenca,72,54,100,220,434,880
16040,buenache,cuenca,24,16,20,50,110,220
16041,buendia,cuenca,68,40,100,198,448,854
16042,campillo,cuenca,320,166,286,652,1124,2548
16043,campillos-paravientos,cuenca,18,12,16,64,110,220
16044,campillos-sierra,cuenca,0,2,12,8,42,64
16045,canalejas,cuenca,6,18,26,48,216,314
16046,canada,cuenca,32,20,44,86,274,456
16047,canada,cuenca,22,22,56,76,254,430
16048,canamares,cuenca,102,60,78,256,428,924
16049,"canavate,",cuenca,10,10,12,68,158,258
16050,canaveras,cuenca,44,40,46,118,220,468
16051,canaveruelas,cuenca,8,2,34,50,142,236
16052,canete,cuenca,232,146,204,434,690,1706
16053,canizares,cuenca,70,56,114,186,462,888
16055,carboneras,cuenca,198,104,158,384,734,1578
16056,cardenete,cuenca,68,40,110,192,538,948
16057,carrascosa,cuenca,4,8,2,30,94,138
16058,carrascosa,cuenca,8,10,10,44,112,184
16060,casas,cuenca,154,118,176,376,854,1678
16061,casas,cuenca,246,178,286,500,1008,2218
16062,casas,cuenca,6,2,6,18,28,60
16063,casas,cuenca,16,6,10,46,138,216
16064,casas,cuenca,200,112,178,446,754,1690
16065,casas,cuenca,72,24,74,208,402,780
16066,casasimarro,cuenca,1110,502,770,1708,2342,6432
16067,castejon,cuenca,10,14,26,66,158,274
16068,castillejo,cuenca,14,16,26,58,126,240
16070,castillejo-sierra,cuenca,2,4,10,12,38,66
16071,castillo-albaranez,cuenca,4,0,4,16,18,42
16072,castillo,cuenca,16,6,28,58,164,272
16073,cervera,cuenca,38,22,30,108,220,418
16074,"cierva,",cuenca,0,4,2,22,50,78
16078,cuenca,cuenca,17502,8596,11724,31136,38328,107286
16079,cueva,cuenca,2,6,0,6,38,52
16081,chumillas,cuenca,20,6,8,30,48,112
16082,enguidanos,cuenca,52,44,54,154,288,592
16083,fresneda,cuenca,0,6,8,20,46,80
16084,fresneda,cuenca,0,0,8,10,64,82
16085,"frontera,",cuenca,30,18,36,102,122,308
16086,fuente,cuenca,378,192,332,736,914,2552
16087,fuentelespino,cuenca,42,26,48,102,272,490
16088,fuentelespino,cuenca,12,6,22,38,132,210
16089,fuentes,cuenca,118,66,100,288,368,940
16091,fuertescusa,cuenca,6,10,10,24,88,138
16092,gabaldon,cuenca,24,28,30,92,146,320
16093,garaballa,cuenca,0,8,18,30,70,126
16094,gascuena,cuenca,24,16,16,72,136,264
16095,graja,cuenca,16,12,16,36,88,168
16096,graja,cuenca,102,64,100,224,242,732
16097,henarejos,cuenca,6,6,6,64,180,262
16098,"herrumblar,",cuenca,240,110,214,412,586,1562
16099,"hinojosa,",cuenca,30,4,34,88,236,392
16100,"hinojosos,",cuenca,160,104,124,334,720,1442
16101,"hito,",cuenca,8,12,16,46,178,260
16102,honrubia,cuenca,402,256,338,862,1240,3098
16103,hontanaya,cuenca,10,24,36,112,342,524
16104,hontecillas,cuenca,8,0,2,30,70,110
16106,horcajo,cuenca,1228,578,852,2216,2744,7618
16107,huelamo,cuenca,2,10,4,32,100,148
16108,huelves,cuenca,24,4,14,52,90,184
16109,huerguina,cuenca,2,4,8,22,52,88
16110,huerta,cuenca,20,22,36,82,106,266
16111,huerta,cuenca,30,28,50,82,156,346
16112,huete,cuenca,460,298,408,910,1590,3666
16113,iniesta,cuenca,1488,854,1136,2582,2968,9028
16115,laguna,cuenca,20,4,6,30,58,118
16116,lagunaseca,cuenca,0,6,10,20,62,98
16117,landete,cuenca,280,180,280,626,1112,2478
16118,ledana,cuenca,402,212,312,846,1480,3252
16119,leganiel,cuenca,62,24,60,108,202,456
16121,"majadas,",cuenca,8,24,48,114,244,438
16122,mariana,cuenca,110,24,48,202,250,634
16123,masegosa,cuenca,0,2,12,28,78,120
16124,"mesas,",cuenca,582,298,500,1242,1938,4560
16125,minglanilla,cuenca,802,406,628,1350,1518,4704
16126,mira,cuenca,260,126,162,546,766,1860
16128,monreal,cuenca,4,8,6,14,60,92
16129,montalbanejo,cuenca,0,6,12,34,118,170
16130,montalbo,cuenca,200,78,172,382,606,1438
16131,monteagudo,cuenca,0,10,30,68,142,250
16132,mota,cuenca,0,2,2,6,42,52
16133,mota,cuenca,2170,938,1294,3538,4278,12218
16134,motilla,cuenca,2208,1052,1794,3534,3996,12584
16135,moya,cuenca,18,18,12,58,188,294
16137,narboneta,cuenca,2,2,8,16,58,86
16139,olivares,cuenca,32,46,54,102,372,606
16140,olmeda,cuenca,0,4,4,6,26,40
16141,olmeda,cuenca,4,10,30,52,150,246
16142,olmedilla,cuenca,20,14,16,78,132,260
16143,olmedilla,cuenca,2,0,6,12,18,38
16145,osa,cuenca,82,46,94,162,500,884
16146,pajaron,cuenca,4,6,6,26,108,150
16147,pajaroncillo,cuenca,14,8,12,28,64,126
16148,palomares,cuenca,72,64,128,208,638,1110
16149,palomera,cuenca,38,14,22,128,180,382
16150,paracuellos,cuenca,6,18,14,44,116,198
16151,paredes,cuenca,10,6,18,30,74,138
16152,parra,cuenca,2,6,4,10,48,70
16153,"pedernoso,",cuenca,278,186,260,578,932,2234
16154,"pedroneras,",cuenca,2120,974,1386,4214,4478,13172
16155,"peral,",cuenca,166,108,158,374,510,1316
16156,"peraleja,",cuenca,6,4,14,44,90,158
16157,"pesquera,",cuenca,70,20,46,114,220,470
16158,"picazo,",cuenca,212,102,162,398,540,1414
16159,pinarejo,cuenca,16,8,16,82,242,364
16160,pineda,cuenca,6,4,10,30,64,114
16161,piqueras,cuenca,2,4,8,20,54,88
16162,portalrubio,cuenca,8,0,4,20,52,84
16163,portilla,cuenca,4,0,8,24,86,122
16165,poyatos,cuenca,8,12,10,40,76,146
16166,pozoamargo,cuenca,32,26,62,114,292,526
16167,pozorrubio,cuenca,48,36,62,124,346,616
16169,"pozuelo,",cuenca,2,2,0,16,64,84
16170,priego,cuenca,220,160,194,510,756,1840
16171,"provencio,",cuenca,762,322,460,1258,1924,4726
16172,puebla,cuenca,28,30,56,88,422,624
16173,valle,cuenca,30,12,42,86,246,416
16174,puebla,cuenca,44,26,34,104,192,400
16175,quintanar,cuenca,2916,1196,1928,4484,4690,15214
16176,rada,cuenca,24,12,4,18,40,98
16177,reillo,cuenca,8,12,34,50,106,210
16181,rozalen,cuenca,8,8,2,22,68,108
16185,saceda-trasierra,cuenca,2,0,4,20,58,84
16186,saelices,cuenca,84,52,100,212,490,938
16187,salinas,cuenca,14,10,12,34,80,150
16188,salmeroncillos,cuenca,30,12,8,54,96,200
16189,salvacanete,cuenca,64,42,46,136,282,570
16190,san,cuenca,2330,1066,1566,3736,5002,13700
16191,san,cuenca,288,186,268,638,894,2274
16192,san,cuenca,2,8,4,18,46,78
16193,san,cuenca,2,0,2,22,86,112
16194,santa,cuenca,30,20,40,88,288,466
16195,santa,cuenca,90,98,68,236,560,1052
16196,santa,cuenca,154,64,110,348,662,1338
16197,santa,cuenca,2,6,6,20,92,126
16198,sisante,cuenca,482,254,332,824,1432,3324
16199,solera,cuenca,2,2,6,8,52,70
16202,talayuelas,cuenca,250,130,138,438,802,1758
16203,tarancon,cuenca,6342,2574,4360,10330,9742,33348
16204,tebar,cuenca,70,44,76,152,260,602
16205,tejadillos,cuenca,20,18,10,54,110,212
16206,tinajas,cuenca,38,14,30,68,242,392
16209,torralba,cuenca,2,22,14,48,150,236
16211,torrejoncillo,cuenca,14,22,44,132,462,674
16212,torrubia,cuenca,78,40,72,148,288,626
16213,torrubia,cuenca,2,2,12,20,50,86
16215,tragacete,cuenca,28,32,50,146,264,520
16216,tresjuncos,cuenca,24,14,44,102,342,526
16217,tribaldos,cuenca,20,8,2,54,114,198
16218,ucles,cuenca,50,42,32,108,244,476
16219,una,cuenca,0,4,26,48,100,178
16224,valdemeca,cuenca,8,12,10,46,88,164
16225,valdemorillo,cuenca,8,2,12,18,74,114
16227,valdemoro-sierra,cuenca,12,16,10,34,134,206
16228,valdeolivas,cuenca,24,24,64,108,198,418
16231,valhermoso,cuenca,10,0,8,36,64,118
16234,valsalobre,cuenca,0,2,2,6,30,40
16236,valverde,cuenca,310,156,260,544,928,2198
16237,valverdejo,cuenca,12,6,16,34,108,176
16238,vara,cuenca,74,46,78,238,512,948
16239,vega,cuenca,18,10,24,50,190,292
16240,vellisca,cuenca,14,2,24,64,146,250
16242,villaconejos,cuenca,56,46,50,154,362,668
16243,villaescusa,cuenca,60,78,122,224,440,924
16244,villagarcia,cuenca,182,76,190,366,736,1550
16245,villalba,cuenca,128,82,94,300,524,1128
16246,villalba,cuenca,56,48,126,180,554,964
16247,villalgordo,cuenca,6,2,12,32,80,132
16248,villalpardo,cuenca,242,120,258,492,882,1994
16249,villamayor,cuenca,550,404,508,1216,2104,4782
16250,villanueva,cuenca,0,4,6,18,86,114
16251,villanueva,cuenca,698,416,654,1258,1780,4806
16253,villar,cuenca,66,36,60,216,360,738
16254,villar,cuenca,22,16,46,108,228,420
16255,villar,cuenca,8,24,16,54,196,298
16258,villar,cuenca,32,12,24,64,226,358
16259,villar,cuenca,2,2,6,12,40,62
16263,villar,cuenca,482,228,402,856,1040,3008
16264,villarejo,cuenca,66,46,56,196,464,828
16265,villarejo,cuenca,0,0,0,10,26,36
16266,villarejo-periesteban,cuenca,58,38,68,162,420,746
16269,villares,cuenca,108,88,82,244,472,994
16270,villarrubio,cuenca,58,26,34,140,174,432
16271,villarta,cuenca,204,162,178,488,670,1702
16272,villas,cuenca,22,24,48,108,254,456
16273,villaverde,cuenca,58,44,50,152,366,670
16274,villora,cuenca,26,8,12,52,152,250
16275,vindel,cuenca,0,0,4,12,18,34
16276,yemeda,cuenca,0,0,2,6,28,36
16277,zafra,cuenca,0,2,2,40,132,176
16278,zafrilla,cuenca,2,10,10,32,52,106
16279,zarza,cuenca,48,36,50,200,212,546
16280,zarzuela,cuenca,14,8,22,64,220,328
16901,campos,cuenca,90,44,106,310,760,1310
16902,valdetortola,cuenca,8,12,30,54,142,246
16903,"valeras,",cuenca,434,238,402,838,1192,3104
16904,fuentenava,cuenca,154,98,100,376,510,1238
16905,arcas,cuenca,1006,346,580,1592,1084,4608
16906,"valdecolmenas,",cuenca,0,2,6,30,102,140
16908,pozorrubielos,cuenca,10,20,36,82,206,354
16909,sotorribas,cuenca,128,78,150,358,698,1412
16910,villar,cuenca,0,4,4,44,102,154
17001,agullana,girona,326,124,180,556,634,1820
17002,aiguaviva,girona,334,148,116,498,504,1600
17003,albanyà,girona,78,10,18,118,110,334
17004,albons,girona,272,116,144,520,604,1656
17005,far,girona,236,118,126,360,412,1252
17006,alp,girona,496,240,552,1062,1104,3454
17007,amer,girona,838,310,462,1366,1866,4842
17008,angles,girona,2250,902,1322,3530,3826,11830
17009,arbucies,girona,2440,1030,1396,3790,4454,13110
17010,argelaguer,girona,124,70,106,250,352,902
17011,"armentera,",girona,412,126,176,712,714,2140
17012,avinyonet,girona,690,332,260,1138,958,3378
17013,begur,girona,1136,608,806,2418,3486,8454
17014,"vajol,",girona,18,6,18,50,104,196
17015,banyoles,girona,8218,3484,4946,11784,12982,41414
17016,bàscara,girona,344,150,230,620,766,2110
17018,bellcaire,girona,250,100,154,422,548,1474
17019,besalu,girona,962,350,468,1514,1860,5154
17020,bescano,girona,2076,832,952,3304,3080,10244
17021,beuda,girona,84,26,34,160,106,410
17022,bisbal,girona,4722,1808,2510,7082,7152,23274
17023,blanes,girona,13448,6944,9518,25136,28824,83870
17024,bolvir,girona,174,80,82,308,350,994
17025,bordils,girona,664,268,430,1024,1216,3602
17026,borrassà,girona,342,98,118,518,472,1548
17027,breda,girona,1234,626,786,2160,3028,7834
17028,brunyola,girona,104,66,80,238,298,786
17029,boadella,girona,70,30,48,144,228,520
17030,cabanes,girona,306,134,240,618,652,1950
17031,cabanelles,girona,110,26,44,198,182,560
17032,cadaques,girona,752,468,644,1910,2014,5788
17033,caldes,girona,3236,1300,1646,5448,5260,16890
17034,calonge,girona,3956,1730,2632,7072,9016,24406
17035,camos,girona,218,108,118,406,576,1426
17036,campdevànol,girona,948,438,624,1756,2734,6500
17037,campelles,girona,40,32,24,94,140,330
17038,campllong,girona,230,126,76,346,310,1088
17039,camprodon,girona,678,350,500,1406,2108,5042
17040,canet,girona,282,78,104,512,512,1488
17041,cantallops,girona,118,50,50,218,256,692
17042,capmany,girona,186,104,162,416,514,1382
17043,queralbs,girona,42,18,56,108,188,412
17044,cassà,girona,4342,1756,2408,6786,6590,21882
17046,castellfollit,girona,264,132,190,524,784,1894
17047,castello,girona,4292,1858,3056,7414,7644,24264
17048,castell,girona,4332,1770,2858,7830,8756,25546
17049,celrà,girona,2556,946,1232,3726,2646,11106
17050,cervià,girona,384,158,138,638,676,1994
17051,cistella,girona,78,50,60,156,244,588
17052,siurana,girona,64,24,46,82,138,354
17054,colera,girona,82,72,106,234,486,980
17055,colomers,girona,44,26,36,112,192,410
17056,cornellà,girona,904,288,482,1482,1632,4788
17057,corçà,girona,464,142,202,754,1002,2564
17058,crespià,girona,80,40,36,180,166,502
17060,darnius,girona,144,68,110,290,486,1098
17061,das,girona,86,42,66,158,188,540
17062,"escala,",girona,3278,1388,2240,6206,8148,21260
17063,espinelves,girona,88,36,48,176,160,508
17064,espolla,girona,102,56,62,248,356,824
17065,esponellà,girona,162,64,54,268,328,876
17066,figueres,girona,19768,8374,12502,29216,27480,97340
17067,flaçà,girona,414,162,280,694,740,2290
17068,foixà,girona,62,42,46,138,294,582
17069,fontanals,girona,166,44,140,270,442,1062
17070,fontanilles,girona,44,30,32,104,126,336
17071,fontcoberta,girona,590,178,250,898,1086,3002
17073,fornells,girona,1180,514,452,1718,1696,5560
17074,fortià,girona,288,126,122,534,532,1602
17075,garrigàs,girona,154,60,74,362,290,940
17076,garrigoles,girona,72,10,52,92,146,372
17077,garriguella,girona,382,102,178,568,704,1934
17078,ger,girona,166,68,112,306,336,988
17079,girona,girona,38864,19764,30024,62634,61666,212952
17080,gombren,girona,58,30,38,114,154,394
17081,gualta,girona,124,70,94,258,310,856
17082,guils,girona,172,62,100,382,420,1136
17083,hostalric,girona,1686,698,948,2860,2694,8886
17084,isòvol,girona,118,16,56,224,246,660
17085,jafre,girona,102,42,82,208,340,774
17086,"jonquera,",girona,1356,596,856,2072,1842,6722
17087,juià,girona,154,80,60,190,206,690
17088,llado,girona,342,110,148,536,520,1656
17089,llagostera,girona,3726,1420,2218,5944,5664,18972
17090,llambilles,girona,258,164,110,418,506,1456
17091,llanars,girona,136,72,84,290,448,1030
17092,llançà,girona,1416,710,946,2922,4102,10096
17093,llers,girona,382,234,254,736,918,2524
17094,llivia,girona,478,200,396,1030,1018,3122
17095,lloret,girona,15358,6386,10084,27152,25288,84268
17096,"llosses,",girona,60,20,40,140,138,398
17097,madremanya,girona,114,28,54,168,212,576
17098,maià,girona,180,104,46,298,348,976
17099,meranges,girona,26,12,8,84,92,222
17100,masarac,girona,88,48,90,176,190,592
17101,massanes,girona,362,104,138,566,516,1686
17102,maçanet,girona,194,82,148,420,706,1550
17103,maçanet,girona,2828,1246,1794,5034,5042,15944
17105,mieres,girona,96,34,78,210,278,696
17106,mollet,girona,64,26,32,122,186,430
17107,mollo,girona,112,36,66,226,306,746
17109,montagut,girona,352,120,208,624,700,2004
17110,mont-ras,girona,500,228,342,824,1488,3382
17111,navata,girona,570,206,284,868,1004,2932
17112,ogassa,girona,50,22,34,124,206,436
17114,olot,girona,13380,6718,10520,21862,25192,77672
17115,ordis,girona,152,56,80,240,264,792
17116,osor,girona,94,44,72,254,380,844
17117,palafrugell,girona,9290,3648,5478,14478,15596,48490
17118,palamos,girona,5736,2766,4098,10892,13746,37238
17119,palau,girona,58,12,18,92,92,272
17120,palau-saverdera,girona,586,208,266,904,1032,2996
17121,palau-sator,girona,90,32,58,204,226,610
17123,palol,girona,176,66,66,280,346,934
17124,pals,girona,780,294,480,1644,1968,5166
17125,pardines,girona,54,18,40,66,144,322
17126,parlavà,girona,148,40,58,258,354,858
17128,pau,girona,158,106,106,334,476,1180
17129,pedret,girona,80,12,26,128,130,376
17130,"pera,",girona,152,50,82,268,352,904
17132,peralada,girona,718,310,426,1188,1452,4094
17133,planes,girona,528,274,342,902,1450,3496
17134,planoles,girona,82,26,56,178,270,612
17135,pont,girona,174,90,106,366,408,1144
17136,pontos,girona,80,40,74,178,206,578
17137,porqueres,girona,1778,758,956,2858,3214,9564
17138,portbou,girona,226,132,218,494,1094,2164
17139,"preses,",girona,720,328,352,1184,1264,3848
17140,port,girona,292,136,252,554,882,2116
17141,puigcerdà,girona,3448,1834,2606,6312,5882,20082
17142,quart,girona,1970,590,720,2806,2112,8198
17143,rabos,girona,82,26,40,148,182,478
17144,regencos,girona,84,44,48,158,224,558
17145,ribes,girona,440,246,354,1044,1608,3692
17146,riells,girona,1492,760,942,2990,2810,8994
17147,ripoll,girona,3522,1524,2206,5940,8354,21546
17148,riudarenes,girona,856,356,598,1512,1566,4888
17149,riudaura,girona,228,68,84,374,302,1056
17150,riudellots,girona,752,360,444,1308,1392,4256
17151,riumors,girona,76,22,72,166,192,528
17152,roses,girona,7186,3278,4632,12024,13390,40510
17153,rupià,girona,142,40,56,192,228,658
17154,sales,girona,36,20,36,74,148,314
17155,salt,girona,15854,6182,9162,20846,15848,67892
17157,sant,girona,76,24,42,86,118,346
17158,sant,girona,194,76,266,462,352,1350
17159,sant,girona,286,76,164,536,694,1756
17160,sant,girona,7982,3586,4820,13448,16032,45868
17161,sant,girona,690,306,306,944,1094,3340
17162,sant,girona,112,34,30,146,150,472
17163,sant,girona,1910,644,730,2744,2460,8488
17164,sant,girona,2124,786,1270,3410,4348,11938
17165,sant,girona,314,60,192,484,652,1702
17166,sant,girona,326,122,184,562,540,1734
17167,sant,girona,1050,344,636,1800,2916,6746
17168,sant,girona,210,70,96,310,366,1052
17169,sant,girona,1486,596,780,2330,2086,7278
17170,vallfogona,girona,54,14,42,138,196,444
17171,sant,girona,72,28,38,156,222,516
17172,sant,girona,280,96,138,464,432,1410
17173,sant,girona,84,60,54,150,176,524
17174,sant,girona,90,34,50,160,166,500
17175,sant,girona,336,90,212,458,584,1680
17176,sant,girona,36,16,22,98,156,328
17177,sant,girona,208,56,142,378,660,1444
17178,sant,girona,810,310,510,1406,1378,4414
17180,santa,girona,5402,2292,3320,8348,8386,27748
17181,santa,girona,2124,886,1136,3626,3894,11666
17182,santa,girona,166,66,116,232,220,800
17183,sant,girona,118,34,78,214,300,744
17184,santa,girona,540,170,228,976,1306,3220
17185,sant,girona,1044,380,578,1896,2308,6206
17186,sarrià,girona,2148,772,1094,3538,3204,10756
17187,"saus,",girona,320,108,166,538,684,1816
17188,selva,girona,50,16,50,122,202,440
17189,cellera,girona,654,304,424,1034,1610,4026
17190,serinyà,girona,470,156,250,762,754,2392
17191,serra,girona,82,38,40,132,170,462
17192,setcases,girona,40,14,40,112,178,384
17193,sils,girona,2596,1116,1438,4314,3948,13412
17194,susqueda,girona,18,14,20,46,92,190
17195,tallada,girona,144,70,74,264,400,952
17196,terrades,girona,104,54,58,206,262,684
17197,torrent,girona,56,24,28,100,140,348
17198,torroella,girona,260,98,180,528,474,1540
17199,torroella,girona,4300,1872,2930,7316,8424,24842
17200,tortellà,girona,270,94,150,510,632,1656
17201,toses,girona,60,36,50,114,124,384
17202,tossa,girona,1864,922,1506,3698,4492,12482
17203,ultramort,girona,78,22,22,132,174,428
17204,ullà,girona,590,162,250,778,662,2442
17205,ullastret,girona,84,42,42,162,202,532
17206,urus,girona,38,34,54,118,170,414
17207,vall,girona,1176,408,596,1940,2322,6442
17208,vall,girona,500,178,276,834,906,2694
17209,vall-llobrega,girona,306,194,152,584,588,1824
17210,ventallo,girona,312,100,182,584,604,1782
17211,verges,girona,388,162,228,638,944,2360
17212,vidrà,girona,64,22,36,78,138,338
17213,vidreres,girona,2970,1412,1874,5380,5674,17310
17214,vilabertran,girona,392,124,196,588,674,1974
17215,vilablareix,girona,1782,422,748,2554,2038,7544
17216,viladasens,girona,80,22,58,104,160,424
17217,viladamat,girona,146,62,78,292,406,984
17218,vilademuls,girona,346,98,144,594,548,1730
17220,viladrau,girona,408,132,220,738,852,2350
17221,vilafant,girona,2118,876,1118,3256,4024,11392
17222,vilaur,girona,66,34,22,106,112,340
17223,vilajuïga,girona,400,184,270,686,826,2366
17224,vilallonga,girona,104,44,74,272,296,790
17225,vilamacolum,girona,150,42,110,206,238,746
17226,vilamalla,girona,446,178,286,678,852,2440
17227,vilamaniscle,girona,52,34,46,100,172,404
17228,vilanant,girona,144,48,48,286,278,804
17230,vila-sacra,girona,362,114,164,546,444,1630
17232,vilopriu,girona,68,30,42,102,184,426
17233,vilobi,girona,1224,468,752,2044,2120,6608
17234,biure,girona,52,30,30,140,198,450
17901,"cruïlles,",girona,404,186,242,716,1098,2646
17902,forallac,girona,572,228,302,1046,1374,3522
17903,sant,girona,516,240,306,842,870,2774
18001,agron,granada,72,22,68,110,216,488
18002,alamedilla,granada,96,86,98,320,492,1092
18003,albolote,granada,7484,3188,4606,12098,11732,39108
18004,albondon,granada,172,40,188,410,652,1462
18005,albunan,granada,100,48,88,218,394,848
18006,albunol,granada,2858,1064,2334,4754,3800,14810
18007,albunuelas,granada,148,102,130,392,816,1588
18010,aldeire,granada,148,54,106,304,570,1182
18011,alfacar,granada,2062,924,1542,3322,3776,11626
18012,algarinejo,granada,522,276,482,1162,2220,4662
18013,alhama,granada,1886,892,1282,3294,3944,11298
18014,alhendin,granada,4834,1452,2472,7442,4648,20848
18015,alicun,granada,114,66,108,226,398,912
18016,almegijar,granada,54,30,58,152,362,656
18017,almunecar,granada,8466,4008,5384,16154,21386,55398
18018,alquife,granada,86,52,130,254,568,1090
18020,arenas,granada,144,86,142,328,530,1230
18021,armilla,granada,9104,4222,6708,16186,14480,50700
18022,atarfe,granada,9138,2950,4996,13712,10188,40984
18023,baza,granada,7010,3196,4958,11614,14372,41150
18024,beas,granada,270,156,216,522,856,2020
18025,beas,granada,94,38,68,148,284,632
18027,benalua,granada,1334,570,802,1958,2024,6688
18028,benalua,granada,250,146,268,488,896,2048
18029,benamaurel,granada,730,300,472,1200,1792,4494
18030,berchules,granada,158,70,150,400,618,1396
18032,bubion,granada,48,38,62,184,298,630
18033,busquistar,granada,74,38,86,188,240,626
18034,cacin,granada,92,64,92,274,548,1070
18035,cadiar,granada,400,192,322,794,1360,3068
18036,cajar,granada,1970,978,1232,3348,3448,10976
18037,calicasas,granada,208,78,194,408,442,1330
18038,campotejar,granada,278,188,352,628,1054,2500
18039,caniles,granada,1100,490,866,2056,3344,7856
18040,canar,granada,126,34,104,210,328,802
18042,capileira,granada,178,96,114,340,428,1156
18043,carataunas,granada,48,30,48,136,192,454
18044,castaras,granada,32,12,40,150,196,430
18045,castillejar,granada,278,148,272,574,1328,2600
18046,castril,granada,394,306,398,970,1870,3938
18047,cenes,granada,2772,1474,2028,5668,4744,16686
18048,cijuela,granada,1680,578,1026,2386,1788,7458
18049,cogollos,granada,138,80,164,288,600,1270
18050,cogollos,granada,762,274,544,1100,1514,4194
18051,colomera,granada,398,200,304,678,988,2568
18053,cortes,granada,390,262,292,908,1738,3590
18054,cortes,granada,240,154,206,498,836,1934
18056,cullar,granada,1034,556,876,2014,3394,7874
18057,cullar,granada,3102,1612,1604,5090,4228,15636
18059,chauchina,granada,2330,1060,1272,3566,3368,11596
18061,chimeneas,granada,338,188,330,666,960,2482
18062,churriana,granada,7316,2282,4078,11646,8090,33412
18063,darro,granada,786,354,464,868,928,3400
18064,dehesas,granada,90,42,70,166,398,766
18065,dehesas,granada,142,90,152,350,548,1282
18066,deifontes,granada,982,382,612,1386,1878,5240
18067,diezma,granada,266,118,194,426,634,1638
18068,dilar,granada,784,390,500,1506,1464,4644
18069,dolar,granada,168,74,94,342,534,1212
18070,dudar,granada,82,56,64,208,342,752
18071,durcal,granada,2286,1106,1648,4266,5130,14436
18072,escuzar,granada,288,108,194,470,626,1686
18074,ferreira,granada,74,42,58,166,266,606
18076,fonelas,granada,334,164,260,508,662,1928
18077,fornes,granada,88,64,130,268,514,1064
18078,freila,granada,266,118,208,458,844,1894
18079,fuente,granada,1676,870,1142,2632,2946,9266
18082,galera,granada,232,130,186,542,1124,2214
18083,gobernador,granada,46,24,40,130,238,478
18084,gojar,granada,2376,1062,1518,3830,3882,12668
18085,gor,granada,82,58,148,312,926,1526
18086,gorafe,granada,54,42,68,166,414,744
18087,granada,granada,72774,35522,56120,126634,176014,467064
18088,guadahortuna,granada,802,344,444,910,1192,3692
18089,guadix,granada,6522,2860,4390,10844,12842,37458
18093,gualchos,granada,2048,728,1476,3324,3018,10594
18094,guejar,granada,818,414,674,1824,2158,5888
18095,guevejar,granada,1066,474,708,1606,1532,5386
18096,huelago,granada,130,48,86,202,276,742
18097,hueneja,granada,310,188,216,702,962,2378
18098,huescar,granada,2124,1208,1450,3960,5722,14464
18099,huetor,granada,538,294,466,1088,1502,3888
18100,huetor,granada,3822,1748,2826,6544,6400,21340
18101,huetor,granada,4172,2212,2744,7344,8086,24558
18102,illora,granada,3116,1522,2298,5332,7548,19816
18103,itrabo,granada,298,110,238,596,746,1988
18105,iznalloz,granada,2390,936,1284,2736,2998,10344
18106,jatar,granada,176,126,160,354,416,1232
18107,jayena,granada,226,156,228,546,836,1992
18108,jerez,granada,202,154,172,470,966,1964
18109,jete,granada,204,116,258,606,808,1992
18111,jun,granada,1896,704,918,2724,2106,8348
18112,juviles,granada,44,14,28,88,122,296
18114,"calahorra,",granada,142,84,134,390,606,1356
18115,lachar,granada,1478,636,1022,2308,2166,7610
18116,lanjaron,granada,984,472,810,2048,3042,7356
18117,lanteira,granada,122,80,108,284,494,1088
18119,lecrin,granada,558,296,484,1164,2046,4548
18120,lentegi,granada,94,40,84,176,312,706
18121,lobras,granada,10,16,38,82,126,272
18122,loja,granada,7520,3436,4822,11474,14376,41628
18123,lugros,granada,60,44,38,168,312,622
18124,lujar,granada,98,48,142,292,406,986
18126,"malaha,",granada,658,266,424,1196,1218,3762
18127,maracena,granada,8384,3766,5014,14154,13422,44740
18128,marchal,granada,196,74,92,180,318,860
18132,moclin,granada,834,484,818,1758,3182,7076
18133,molvizar,granada,880,388,716,1504,2048,5536
18134,monachil,granada,2960,1342,2074,5792,5014,17182
18135,montefrio,granada,1474,764,1340,2650,4336,10564
18136,montejicar,granada,632,294,462,1070,1602,4060
18137,montillana,granada,192,148,304,540,932,2116
18138,moraleda,granada,1012,484,676,1790,2318,6280
18140,motril,granada,22398,9932,13546,36470,37388,119734
18141,murtas,granada,84,56,68,246,430,884
18143,niguelas,granada,346,162,268,688,1004,2468
18144,nivar,granada,426,118,212,714,668,2138
18145,ogijares,granada,5722,2582,3382,9158,9250,30094
18146,orce,granada,300,154,240,584,1014,2292
18147,orgiva,granada,1716,720,1226,3188,4644,11494
18148,otivar,granada,278,192,224,640,764,2098
18149,villa,granada,2796,1270,1470,4694,4970,15200
18150,padul,granada,3424,1450,2336,5728,6134,19072
18151,pampaneira,granada,82,36,76,192,246,632
18152,pedro,granada,418,178,254,564,878,2292
18153,peligros,granada,4576,2014,2718,7186,6828,23322
18154,"peza,",granada,348,200,226,540,914,2228
18157,pinos,granada,592,274,402,982,1036,3286
18158,pinos,granada,3688,1576,2282,4980,6918,19444
18159,pinar,granada,232,152,282,572,914,2152
18161,policar,granada,52,22,62,156,240,532
18162,polopos,granada,496,276,490,1054,1026,3342
18163,portugos,granada,108,52,70,214,332,776
18164,puebla,granada,768,344,548,1122,1624,4406
18165,pulianas,granada,2158,1028,1466,3282,3372,11306
18167,purullena,granada,894,394,568,1306,1554,4716
18168,quentar,granada,230,116,212,552,788,1898
18170,rubite,granada,64,36,92,252,424,868
18171,salar,granada,920,426,644,1352,1862,5204
18173,salobrena,granada,3774,2092,2646,7206,9498,25216
18174,santa,granada,118,76,110,284,436,1024
18175,santa,granada,5530,2446,3630,8854,10142,30602
18176,soportujar,granada,34,44,68,166,254,566
18177,sorvilan,granada,100,72,116,226,506,1020
18178,torre-cardela,granada,116,102,136,306,768,1428
18179,torvizcon,granada,130,60,116,344,590,1240
18180,trevelez,granada,150,114,150,392,600,1406
18181,turon,granada,24,22,30,116,238,430
18182,ugijar,granada,904,394,616,1392,1838,5144
18183,valor,granada,138,66,106,332,704,1346
18184,velez,granada,858,446,724,1658,2396,6082
18185,ventas,granada,178,68,186,376,544,1352
18187,villanueva,granada,112,50,128,268,482,1040
18188,villanueva,granada,662,270,468,1062,1498,3960
18189,viznar,granada,330,150,220,586,706,1992
18192,zafarraya,granada,916,360,474,1274,1454,4478
18193,"zubia,",granada,7062,3442,4784,12282,12584,40154
18194,zujar,granada,746,392,644,1426,2038,5246
18901,"taha,",granada,192,76,152,454,704,1578
18902,"valle,",granada,184,102,148,524,936,1894
18903,nevada,granada,286,136,232,568,976,2198
18904,alpujarra,granada,140,126,244,538,876,1924
18905,"gabias,",granada,9632,3656,5820,17032,10844,46984
18906,"guajares,",granada,174,140,200,646,1112,2272
18907,valle,granada,696,312,452,1118,1658,4236
18908,villamena,granada,288,140,204,578,800,2010
18909,morelabor,granada,160,86,128,284,518,1176
18910,"pinar,",granada,180,120,194,420,832,1746
18911,vegas,granada,6392,1808,2302,9540,4604,24646
18912,cuevas,granada,488,276,490,820,1530,3604
18913,zagra,granada,298,158,174,444,706,1780
18914,valderrubio,granada,728,364,460,1194,1410,4156
18915,domingo,granada,268,142,190,352,718,1670
18916,torrenueva,granada,962,462,832,1874,2112,6242
19001,abanades,guadalajara,4,8,10,28,72,122
19002,ablanque,guadalajara,4,0,6,24,112,146
19003,adobes,guadalajara,2,0,6,16,32,56
19004,alaminos,guadalajara,2,4,6,26,74,112
19005,alarilla,guadalajara,24,12,38,84,120,278
19006,albalate,guadalajara,266,116,190,714,1014,2300
19007,albares,guadalajara,176,86,114,288,560,1224
19008,albendiego,guadalajara,8,4,6,32,38,88
19009,alcocer,guadalajara,66,30,50,150,348,644
19010,alcolea,guadalajara,4,2,0,6,16,28
19011,alcolea,guadalajara,108,46,58,202,258,672
19013,alcoroches,guadalajara,10,10,26,70,136,252
19015,aldeanueva,guadalajara,12,2,16,38,144,212
19016,algar,guadalajara,0,2,6,24,60,92
19017,algora,guadalajara,8,20,20,66,82,196
19018,alhondiga,guadalajara,18,18,36,86,194,352
19019,alique,guadalajara,0,2,2,6,20,30
19020,almadrones,guadalajara,8,6,16,54,60,144
19021,almoguera,guadalajara,498,228,322,794,936,2778
19022,almonacid,guadalajara,130,80,162,332,648,1352
19023,alocen,guadalajara,50,30,24,84,124,312
19024,alovera,guadalajara,6214,2634,2660,10310,5432,27250
19027,alustante,guadalajara,20,18,18,72,174,302
19031,angon,guadalajara,0,0,0,4,10,14
19032,anguita,guadalajara,8,10,10,70,216,314
19033,anquela,guadalajara,0,0,2,30,70,102
19034,anquela,guadalajara,6,0,4,22,26,58
19036,aranzueque,guadalajara,150,36,90,228,294,798
19037,arbancon,guadalajara,22,12,20,94,148,296
19038,arbeteta,guadalajara,0,0,0,4,28,32
19039,argecilla,guadalajara,0,8,10,34,94,146
19040,armallones,guadalajara,2,0,8,20,78,108
19041,armuna,guadalajara,78,32,64,178,180,532
19042,arroyo,guadalajara,0,4,10,8,44,66
19043,atanzon,guadalajara,0,0,10,50,112,172
19044,atienza,guadalajara,98,52,116,238,346,850
19045,aunon,guadalajara,10,16,22,68,202,318
19046,azuqueca,guadalajara,14542,5904,8168,25032,17704,71350
19047,baides,guadalajara,4,0,10,14,74,102
19048,banos,guadalajara,0,0,4,4,20,28
19049,banuelos,guadalajara,0,2,4,4,16,26
19050,barriopedro,guadalajara,4,2,2,8,32,48
19051,berninches,guadalajara,0,2,4,10,72,88
19052,"bodera,",guadalajara,0,0,2,6,32,40
19053,brihuega,guadalajara,798,356,600,1528,2434,5716
19054,budia,guadalajara,28,24,32,92,258,434
19055,bujalaro,guadalajara,14,0,8,24,58,104
19057,bustares,guadalajara,6,2,10,20,98,136
19058,cabanillas,guadalajara,4686,2108,2540,7182,6108,22624
19059,campillo,guadalajara,10,0,4,46,88,148
19060,campillo,guadalajara,8,4,4,96,194,306
19061,campisabalos,guadalajara,6,0,12,52,92,162
19064,canredondo,guadalajara,4,2,12,24,120,162
19065,cantalojas,guadalajara,34,10,20,52,116,232
19066,canizar,guadalajara,2,14,6,44,80,146
19067,cardoso,guadalajara,2,10,6,22,62,102
19070,casa,guadalajara,28,6,16,70,102,222
19071,"casar,",guadalajara,5784,2380,2392,9816,6792,27164
19073,casas,guadalajara,0,4,2,10,24,40
19074,caspuenas,guadalajara,8,14,18,86,140,266
19075,castejon,guadalajara,6,2,6,30,74,118
19076,castellar,guadalajara,0,4,2,4,30,40
19078,castilforte,guadalajara,2,6,4,24,74,110
19079,castilnuevo,guadalajara,0,2,2,2,10,16
19080,cendejas,guadalajara,6,6,10,32,90,144
19081,cendejas,guadalajara,4,0,0,8,40,52
19082,centenera,guadalajara,42,12,38,86,106,284
19086,cifuentes,guadalajara,316,190,350,822,1708,3386
19087,cincovillas,guadalajara,0,2,6,2,32,42
19088,ciruelas,guadalajara,36,6,8,106,124,280
19089,ciruelos,guadalajara,8,2,0,16,26,52
19090,cobeta,guadalajara,16,20,16,52,102,206
19091,cogollor,guadalajara,0,0,6,4,30,40
19092,cogolludo,guadalajara,142,64,100,340,478,1124
19095,condemios,guadalajara,0,0,6,8,14,28
19096,condemios,guadalajara,16,10,10,82,108,226
19097,congostrina,guadalajara,2,4,0,8,20,34
19098,copernal,guadalajara,14,0,16,28,36,94
19099,corduente,guadalajara,42,40,66,152,282,582
19102,cubillo,guadalajara,26,12,12,82,86,218
19103,checa,guadalajara,32,40,52,134,288,546
19104,chequilla,guadalajara,0,4,2,0,22,28
19105,chiloeches,guadalajara,1796,682,728,3094,1832,8132
19106,chillaron,guadalajara,12,10,8,48,98,176
19107,driebes,guadalajara,82,46,66,142,350,686
19108,duron,guadalajara,2,18,16,44,144,224
19109,embid,guadalajara,0,2,0,18,46,66
19110,escamilla,guadalajara,2,6,18,28,78,132
19111,escariche,guadalajara,22,18,38,100,192,370
19112,escopete,guadalajara,20,6,14,24,92,156
19113,espinosa,guadalajara,166,116,146,418,530,1376
19114,esplegares,guadalajara,6,0,12,14,34,66
19115,estables,guadalajara,8,6,6,20,28,68
19116,estriegana,guadalajara,2,2,2,2,14,22
19117,fontanar,guadalajara,1146,378,524,1872,1364,5284
19118,fuembellida,guadalajara,2,0,0,16,10,28
19119,fuencemillan,guadalajara,12,8,20,42,96,178
19120,fuentelahiguera,guadalajara,18,12,14,66,132,242
19121,fuentelencina,guadalajara,96,56,54,174,304,684
19122,fuentelsaz,guadalajara,14,4,6,50,98,172
19123,fuentelviejo,guadalajara,6,2,6,30,68,112
19124,fuentenovilla,guadalajara,172,46,120,434,440,1212
19125,gajanejos,guadalajara,6,6,22,30,46,110
19126,galapagos,guadalajara,1278,422,488,2140,1236,5564
19127,galve,guadalajara,6,14,22,36,116,194
19129,gascuena,guadalajara,0,0,6,12,32,50
19130,guadalajara,guadalajara,32850,14812,22006,53730,58358,181756
19132,henche,guadalajara,8,6,14,24,116,168
19133,heras,guadalajara,114,42,50,162,126,494
19134,herreria,guadalajara,0,0,2,18,14,34
19135,hiendelaencina,guadalajara,24,0,18,54,130,226
19136,hijes,guadalajara,8,6,4,4,20,42
19138,hita,guadalajara,58,30,60,212,294,654
19139,hombrados,guadalajara,4,8,12,32,34,90
19142,hontoba,guadalajara,94,34,72,332,344,876
19143,horche,guadalajara,1148,490,658,1922,1646,5864
19145,hortezuela,guadalajara,0,4,0,20,44,68
19146,"huerce,",guadalajara,2,0,10,18,80,110
19147,huermeces,guadalajara,0,2,0,14,70,86
19148,huertahernando,guadalajara,4,0,8,48,58,118
19150,hueva,guadalajara,12,14,30,64,110,230
19151,humanes,guadalajara,604,204,390,1098,1298,3594
19152,illana,guadalajara,264,114,206,596,698,1878
19153,iniestola,guadalajara,0,0,0,14,22,36
19154,"inviernas,",guadalajara,0,0,2,24,80,106
19155,irueste,guadalajara,14,2,14,44,100,174
19156,jadraque,guadalajara,434,192,342,822,1166,2956
19157,jirueque,guadalajara,0,2,4,28,62,96
19159,ledanca,guadalajara,2,4,26,54,118,204
19160,loranca,guadalajara,508,232,348,1288,862,3238
19161,lupiana,guadalajara,124,40,56,218,208,646
19162,luzaga,guadalajara,12,0,10,46,68,136
19163,luzon,guadalajara,6,10,6,28,64,114
19165,majaelrayo,guadalajara,12,4,2,50,46,114
19166,malaga,guadalajara,42,12,26,86,176,342
19167,malaguilla,guadalajara,58,24,70,136,130,418
19168,mandayona,guadalajara,40,16,68,112,362,598
19169,mantiel,guadalajara,6,2,8,10,38,64
19170,maranchon,guadalajara,52,20,34,82,250,438
19171,marchamalo,guadalajara,3654,1166,2030,5852,4182,16884
19172,masegoso,guadalajara,10,2,12,42,94,160
19173,matarrubia,guadalajara,18,8,12,58,62,158
19174,matillas,guadalajara,34,8,22,30,138,232
19175,mazarete,guadalajara,0,0,4,4,46,54
19176,mazuecos,guadalajara,38,22,60,152,302,574
19177,medranda,guadalajara,10,0,8,30,98,146
19178,megina,guadalajara,4,0,6,18,28,56
19179,membrillera,guadalajara,14,14,12,46,108,194
19181,miedes,guadalajara,4,4,8,22,80,118
19182,"mierla,",guadalajara,0,4,4,24,44,76
19183,milmarcos,guadalajara,10,4,8,42,76,140
19184,millana,guadalajara,38,14,34,70,98,254
19185,"minosa,",guadalajara,0,4,4,10,46,64
19186,mirabueno,guadalajara,4,14,8,30,116,172
19187,miralrio,guadalajara,2,4,6,32,66,110
19188,mochales,guadalajara,2,0,2,10,58,72
19189,mohernando,guadalajara,42,22,38,100,132,334
19190,molina,guadalajara,1034,464,716,1908,2582,6704
19191,monasterio,guadalajara,2,0,0,8,20,30
19192,mondejar,guadalajara,1082,538,710,1700,1824,5854
19193,montarron,guadalajara,0,0,8,10,46,64
19194,moratilla,guadalajara,12,6,14,38,126,196
19195,morenilla,guadalajara,8,8,12,24,50,102
19196,muduex,guadalajara,14,8,24,62,114,222
19197,navas,guadalajara,8,0,6,12,50,76
19198,negredo,guadalajara,0,0,4,2,20,26
19199,ocentejo,guadalajara,0,2,4,6,16,28
19200,"olivar,",guadalajara,32,16,10,50,60,168
19201,olmeda,guadalajara,6,6,6,24,72,114
19202,olmeda,guadalajara,4,0,2,24,8,38
19203,"ordial,",guadalajara,2,2,14,18,60,96
19204,orea,guadalajara,58,30,46,86,172,392
19208,palmaces,guadalajara,0,2,4,18,68,92
19209,pardos,guadalajara,2,2,4,20,42,70
19210,paredes,guadalajara,0,2,6,4,32,44
19211,pareja,guadalajara,76,28,62,290,494,950
19212,pastrana,guadalajara,250,98,168,490,836,1842
19213,"pedregal,",guadalajara,2,6,8,34,76,126
19214,penalen,guadalajara,4,4,14,42,88,152
19215,penalver,guadalajara,26,12,24,102,210,374
19216,peralejos,guadalajara,36,22,44,82,142,326
19217,peralveche,guadalajara,8,6,12,28,96,150
19218,pinilla,guadalajara,6,2,12,38,50,108
19219,pinilla,guadalajara,0,0,0,10,14,24
19220,pioz,guadalajara,2590,762,1150,4354,1846,10702
19221,piqueras,guadalajara,14,0,2,18,32,66
19222,pobo,guadalajara,20,8,2,68,106,204
19223,poveda,guadalajara,12,2,28,54,112,208
19224,pozo,guadalajara,16,4,16,52,132,220
19225,pozo,guadalajara,766,248,324,1368,714,3420
19226,pradena,guadalajara,8,8,0,40,48,104
19227,prados,guadalajara,2,6,4,24,64,100
19228,puebla,guadalajara,10,8,4,46,46,114
19229,puebla,guadalajara,8,2,6,18,88,122
19230,quer,guadalajara,512,154,238,856,338,2098
19231,rebollosa,guadalajara,0,0,2,6,12,20
19232,"recuenco,",guadalajara,6,6,4,36,76,128
19233,renera,guadalajara,12,10,8,68,110,208
19234,retiendas,guadalajara,2,4,16,20,66,108
19235,riba,guadalajara,4,8,14,38,124,188
19237,rillo,guadalajara,8,2,4,28,44,86
19238,riofrio,guadalajara,12,8,8,32,60,120
19239,robledillo,guadalajara,66,22,32,130,124,374
19240,robledo,guadalajara,2,2,4,16,58,82
19241,romanillos,guadalajara,4,2,2,22,36,66
19242,romanones,guadalajara,32,10,10,84,100,236
19243,rueda,guadalajara,6,0,4,30,34,74
19244,sacecorbo,guadalajara,10,18,12,32,118,190
19245,sacedon,guadalajara,386,258,322,868,1408,3242
19246,saelices,guadalajara,0,10,12,14,60,96
19247,salmeron,guadalajara,16,14,22,68,176,296
19248,san,guadalajara,0,0,18,34,86,138
19249,san,guadalajara,2,2,2,18,50,74
19250,santiuste,guadalajara,0,0,0,8,26,34
19251,sauca,guadalajara,8,6,12,24,46,96
19252,sayaton,guadalajara,10,10,12,36,76,144
19254,selas,guadalajara,2,2,0,12,54,70
19255,setiles,guadalajara,8,6,10,40,104,168
19256,sienes,guadalajara,2,4,8,12,62,88
19257,siguenza,guadalajara,1390,682,1102,2520,3862,9556
19258,solanillos,guadalajara,2,10,20,40,84,156
19259,somolinos,guadalajara,0,2,6,8,36,52
19260,"sotillo,",guadalajara,0,4,0,10,48,62
19261,sotodosos,guadalajara,0,0,4,14,46,64
19262,tamajon,guadalajara,10,12,14,82,192,310
19263,taragudo,guadalajara,8,10,4,32,40,94
19264,taravilla,guadalajara,4,6,8,16,48,82
19265,tartanedo,guadalajara,24,16,36,70,168,314
19266,tendilla,guadalajara,92,50,86,190,266,684
19267,terzaga,guadalajara,4,2,2,12,20,40
19268,tierzo,guadalajara,6,2,12,10,38,68
19269,"toba,",guadalajara,2,2,26,18,102,150
19270,tordelrabano,guadalajara,0,0,2,2,18,22
19271,tordellego,guadalajara,2,10,0,16,52,80
19272,tordesilos,guadalajara,18,16,16,44,86,180
19274,torija,guadalajara,842,268,378,1276,750,3514
19277,torrecuadrada,guadalajara,4,2,6,14,18,44
19278,torrecuadradilla,guadalajara,0,0,6,16,34,56
19279,torre,guadalajara,80,194,206,466,142,1088
19280,torrejon,guadalajara,2716,992,1218,4774,2920,12620
19281,torremocha,guadalajara,2,2,0,24,18,46
19282,torremocha,guadalajara,20,12,36,90,210,368
19283,torremocha,guadalajara,6,2,10,20,32,70
19284,torremochuela,guadalajara,0,0,0,8,8,16
19285,torrubia,guadalajara,0,0,4,10,38,52
19286,tortola,guadalajara,676,126,250,1086,626,2764
19287,tortuera,guadalajara,40,30,22,82,142,316
19288,tortuero,guadalajara,0,0,2,12,28,42
19289,traid,guadalajara,0,4,4,4,26,38
19290,trijueque,guadalajara,484,202,374,1192,1028,3280
19291,trillo,guadalajara,236,256,318,660,1332,2802
19293,uceda,guadalajara,1184,482,542,2410,1986,6604
19294,ujados,guadalajara,10,2,0,22,22,56
19296,utande,guadalajara,2,2,8,14,36,62
19297,valdarachas,guadalajara,20,2,2,34,52,110
19298,valdearenas,guadalajara,4,8,16,58,94,180
19299,valdeavellano,guadalajara,14,2,6,60,112,194
19300,valdeaveruelo,guadalajara,460,198,262,980,672,2572
19301,valdeconcha,guadalajara,6,0,8,30,46,90
19302,valdegrudas,guadalajara,4,2,8,28,62,104
19303,valdelcubo,guadalajara,4,4,4,18,52,82
19304,valdenuno,guadalajara,84,52,62,248,224,670
19305,valdepenas,guadalajara,16,16,8,70,186,296
19306,valderrebollo,guadalajara,0,2,2,8,38,50
19307,valdesotos,guadalajara,2,0,2,32,26,62
19308,valfermoso,guadalajara,12,0,4,40,94,150
19309,valhermoso,guadalajara,2,6,2,10,18,38
19310,valtablado,guadalajara,0,0,2,0,14,16
19311,valverde,guadalajara,4,8,20,34,116,182
19314,viana,guadalajara,0,4,8,28,42,82
19317,villanueva,guadalajara,20,2,16,112,156,306
19318,villanueva,guadalajara,18,0,0,22,24,64
19319,villanueva,guadalajara,2668,1534,1160,4892,3138,13392
19321,villares,guadalajara,6,0,4,20,64,94
19322,villaseca,guadalajara,0,2,10,10,36,58
19323,villaseca,guadalajara,8,8,20,26,52,114
19324,villel,guadalajara,18,10,38,48,220,334
19325,vinuelas,guadalajara,8,22,34,52,250,366
19326,yebes,guadalajara,2580,672,1432,4340,1776,10800
19327,yebra,guadalajara,122,46,134,260,454,1016
19329,yelamos,guadalajara,12,2,6,28,68,116
19330,yelamos,guadalajara,12,2,24,50,92,180
19331,yunquera,guadalajara,1932,730,1074,3030,2340,9106
19332,"yunta,",guadalajara,8,8,8,46,114,184
19333,zaorejas,guadalajara,4,8,22,48,150,232
19334,zarzuela,guadalajara,0,6,4,32,62,104
19335,zorita,guadalajara,6,4,14,44,64,132
19901,semillas,guadalajara,0,0,2,10,44,56
20001,abaltzisketa,gipuzkoa,86,62,60,188,236,632
20002,aduna,gipuzkoa,228,86,60,320,302,996
20003,aizarnazabal,gipuzkoa,328,102,94,542,494,1560
20004,albiztur,gipuzkoa,154,36,50,194,214,648
20005,alegia,gipuzkoa,646,308,364,1018,1272,3608
20006,alkiza,gipuzkoa,178,60,62,204,204,708
20007,altzo,gipuzkoa,176,96,80,228,308,888
20008,amezketa,gipuzkoa,320,160,166,558,676,1880
20009,andoain,gipuzkoa,4870,2048,2496,8754,10924,29092
20010,anoeta,gipuzkoa,816,270,482,1182,1414,4164
20011,antzuola,gipuzkoa,792,280,318,1252,1498,4140
20012,arama,gipuzkoa,60,36,22,100,138,356
20013,aretxabaleta,gipuzkoa,2496,1112,1212,4180,5374,14374
20014,asteasu,gipuzkoa,574,320,332,916,1004,3146
20015,ataun,gipuzkoa,710,248,264,994,1204,3420
20016,aia,gipuzkoa,928,252,408,1318,1372,4278
20017,azkoitia,gipuzkoa,4502,1668,2310,6688,8180,23348
20018,azpeitia,gipuzkoa,5636,2276,3192,8316,10918,30338
20019,beasain,gipuzkoa,5154,2162,2706,7834,9992,27848
20020,beizama,gipuzkoa,36,16,18,82,108,260
20021,belauntza,gipuzkoa,122,36,48,174,196,576
20022,berastegi,gipuzkoa,392,164,236,600,828,2220
20023,berrobi,gipuzkoa,202,80,112,334,392,1120
20024,bidania-goiatz,gipuzkoa,206,92,96,316,356,1066
20025,zegama,gipuzkoa,654,164,270,920,1074,3082
20026,zerain,gipuzkoa,102,28,56,140,236,562
20027,zestoa,gipuzkoa,1538,504,720,2346,2576,7684
20028,zizurkil,gipuzkoa,1088,514,548,1686,2096,5932
20029,deba,gipuzkoa,1564,820,1038,2870,4502,10794
20030,eibar,gipuzkoa,8920,3702,5124,15162,21690,54598
20031,elduain,gipuzkoa,110,48,36,152,154,500
20032,elgoibar,gipuzkoa,4084,1576,2144,6650,8694,23148
20033,elgeta,gipuzkoa,436,144,186,692,794,2252
20034,eskoriatza,gipuzkoa,1352,726,630,2540,3206,8454
20035,ezkio-itsaso,gipuzkoa,186,86,68,358,480,1178
20036,hondarribia,gipuzkoa,5246,2614,3090,9420,13498,33868
20037,gaintza,gipuzkoa,38,14,26,68,102,248
20038,gabiria,gipuzkoa,142,102,120,282,386,1032
20039,getaria,gipuzkoa,1028,432,678,1666,2024,5828
20040,hernani,gipuzkoa,6426,3236,4168,11624,15236,40690
20041,hernialde,gipuzkoa,78,70,48,184,256,636
20042,ibarra,gipuzkoa,1404,604,764,2222,3218,8212
20043,idiazabal,gipuzkoa,882,338,388,1336,1596,4540
20044,ikaztegieta,gipuzkoa,192,70,98,310,340,1010
20045,irun,gipuzkoa,19548,9442,12730,37282,47594,126596
20046,irura,gipuzkoa,896,276,386,1306,928,3792
20047,itsasondo,gipuzkoa,288,86,120,414,428,1336
20048,larraul,gipuzkoa,102,52,32,172,146,504
20049,lazkao,gipuzkoa,2418,834,1358,3514,3950,12074
20050,leaburu,gipuzkoa,136,66,58,188,322,770
20051,legazpi,gipuzkoa,2670,1092,1472,4552,6972,16758
20052,legorreta,gipuzkoa,540,204,284,818,1046,2892
20053,lezo,gipuzkoa,1890,864,1098,3660,4496,12008
20054,lizartza,gipuzkoa,242,108,144,378,460,1332
20055,arrasate/mondragon,gipuzkoa,6804,2990,4176,11970,18212,44152
20056,mutriku,gipuzkoa,1810,762,860,3124,3990,10546
20057,mutiloa,gipuzkoa,88,40,48,154,176,506
20058,olaberria,gipuzkoa,258,132,192,480,796,1858
20059,onati,gipuzkoa,4240,1588,2100,6196,8876,23000
20060,orexa,gipuzkoa,38,24,10,62,82,216
20061,orio,gipuzkoa,2360,956,1190,3826,4008,12340
20062,ormaiztegi,gipuzkoa,506,188,212,758,862,2526
20063,oiartzun,gipuzkoa,3518,1560,1962,5968,7690,20698
20064,pasaia,gipuzkoa,4708,2440,3450,9646,12266,32510
20065,soraluze-placencia,gipuzkoa,1258,498,720,2204,2898,7578
20066,errezil,gipuzkoa,206,98,118,304,436,1162
20067,errenteria,gipuzkoa,11768,5978,7214,23350,30310,78620
20068,leintz-gatzaga,gipuzkoa,54,20,50,96,200,420
20069,donostia/san,gipuzkoa,53164,27612,41024,101320,153854,376974
20070,segura,gipuzkoa,632,180,296,858,966,2932
20071,tolosa,gipuzkoa,6848,3208,4328,10840,14974,40198
20072,urnieta,gipuzkoa,1968,1124,1346,3570,4490,12498
20073,usurbil,gipuzkoa,2314,1034,1190,3984,4338,12860
20074,bergara,gipuzkoa,4518,2016,2800,7806,11808,28948
20075,villabona,gipuzkoa,1974,922,1144,3256,4404,11700
20076,ordizia,gipuzkoa,4084,1748,2436,5894,7070,21232
20077,urretxu,gipuzkoa,2114,1158,1304,3650,5290,13516
20078,zaldibia,gipuzkoa,764,240,402,864,1200,3470
20079,zarautz,gipuzkoa,7500,3848,4936,12862,17528,46674
20080,zumarraga,gipuzkoa,3004,1444,1704,5388,7836,19376
20081,zumaia,gipuzkoa,3762,1500,1962,5960,7316,20500
20901,mendaro,gipuzkoa,834,364,294,1262,1248,4002
20902,lasarte-oria,gipuzkoa,5974,2722,3634,11632,14516,38478
20903,astigarraga,gipuzkoa,3434,974,1534,5760,3794,15496
20904,baliarrain,gipuzkoa,94,16,26,118,54,308
20905,orendain,gipuzkoa,126,32,38,176,118,490
20906,altzaga,gipuzkoa,76,42,14,90,120,342
20907,gaztelu,gipuzkoa,76,20,30,106,110,342
21001,alajar,huelva,212,128,186,462,596,1584
21002,aljaraque,huelva,9614,3828,4304,15270,11994,45010
21003,"almendro,",huelva,242,90,246,436,700,1714
21004,almonaster,huelva,372,204,356,1076,1498,3506
21005,almonte,huelva,8758,3756,6658,17578,13904,50654
21006,alosno,huelva,1196,524,890,2196,3216,8022
21007,aracena,huelva,3152,1294,1764,5028,5616,16854
21008,aroche,huelva,842,418,722,1704,2304,5990
21009,arroyomolinos,huelva,232,98,202,516,800,1848
21010,ayamonte,huelva,7440,3208,4732,13884,14750,44014
21011,beas,huelva,1444,620,882,2732,3098,8776
21012,berrocal,huelva,36,14,64,162,300,576
21013,bollullos,huelva,5148,2480,3270,8820,9148,28866
21014,bonares,huelva,2108,984,1496,4180,3618,12386
21015,cabezas,huelva,134,118,152,398,622,1424
21016,cala,huelva,292,174,196,646,928,2236
21017,calanas,huelva,902,332,580,1610,2090,5514
21018,"campillo,",huelva,572,246,396,1142,1682,4038
21019,campofrio,huelva,216,138,138,378,584,1454
21020,canaveral,huelva,88,48,100,190,338,764
21021,cartaya,huelva,8424,3330,5520,14518,11054,42846
21022,castano,huelva,28,30,64,112,218,452
21023,cerro,huelva,624,220,480,1182,2028,4534
21024,corteconcepcion,huelva,146,60,144,332,470,1152
21025,cortegana,huelva,1388,616,1000,2772,3476,9252
21026,cortelazor,huelva,86,30,68,192,250,626
21027,cumbres,huelva,12,6,16,38,50,122
21028,cumbres,huelva,36,40,86,150,406,718
21029,cumbres,huelva,478,212,368,932,1474,3464
21030,chucena,huelva,782,386,588,1246,1632,4634
21031,encinasola,huelva,272,160,250,654,1252,2588
21032,escacena,huelva,904,326,546,1376,1478,4630
21033,fuenteheridos,huelva,310,118,176,486,548,1638
21034,galaroza,huelva,392,174,294,750,1142,2752
21035,gibraleon,huelva,4818,1942,2794,8906,8152,26612
21036,granada,huelva,70,34,50,128,206,488
21037,"granado,",huelva,96,38,100,276,478,988
21038,higuera,huelva,368,182,242,700,1106,2598
21039,hinojales,huelva,88,34,58,170,302,652
21040,hinojos,huelva,1404,494,848,2564,2912,8222
21041,huelva,huelva,49406,22414,29918,87534,97780,287052
21042,isla,huelva,7714,3658,5266,13442,13248,43328
21043,jabugo,huelva,686,336,508,1234,1634,4398
21044,lepe,huelva,11304,5006,7870,19734,14850,58764
21045,linares,huelva,84,30,40,174,222,550
21046,lucena,huelva,1208,590,898,2512,1650,6858
21047,manzanilla,huelva,664,346,534,1246,1672,4462
21048,"marines,",huelva,142,74,66,258,314,854
21049,minas,huelva,1026,484,844,1954,3110,7418
21050,moguer,huelva,7972,3848,6456,17352,11114,46742
21051,"nava,",huelva,44,34,46,150,242,516
21052,nerva,huelva,1490,684,1170,2614,4178,10136
21053,niebla,huelva,1544,586,1066,2574,2844,8614
21054,palma,huelva,4214,1746,2486,6332,6642,21420
21055,palos,huelva,4898,2216,3788,9118,5780,25800
21056,paterna,huelva,1050,508,710,1884,2704,6856
21057,paymogo,huelva,394,170,274,644,892,2374
21058,puebla,huelva,980,434,680,1838,2330,6262
21059,puerto,huelva,98,50,92,168,152,560
21060,punta,huelva,4824,2390,3516,10068,11386,32184
21061,rociana,huelva,2920,1190,2020,5368,4552,16050
21062,rosal,huelva,500,260,384,924,1322,3390
21063,san,huelva,1516,552,978,2576,2376,7998
21064,san,huelva,4184,1618,2272,6798,4780,19652
21065,sanlucar,huelva,118,40,68,234,378,838
21066,san,huelva,150,92,140,374,528,1284
21067,santa,huelva,100,70,96,258,428,952
21068,santa,huelva,314,172,222,676,914,2298
21069,santa,huelva,714,316,424,1184,1484,4122
21070,trigueros,huelva,2898,1218,1778,5094,5274,16262
21071,valdelarco,huelva,56,24,30,120,242,472
21072,valverde,huelva,4488,1726,2486,7696,9012,25408
21073,villablanca,huelva,1008,388,750,1902,1950,5998
21074,villalba,huelva,1082,568,706,1924,2340,6620
21075,villanueva,huelva,90,38,74,212,344,758
21076,villanueva,huelva,950,434,678,1882,1980,5924
21077,villarrasa,huelva,686,356,446,1290,1510,4288
21078,zalamea,huelva,754,402,596,1600,2602,5954
21079,zufre,huelva,206,90,152,378,646,1472
21902,"zarza-perrunal,",huelva,226,136,308,514,1198,2382
22001,abiego,huesca,52,24,54,148,250,528
22002,abizanda,huesca,28,8,32,112,146,326
22003,adahuesca,huesca,76,28,30,140,136,410
22004,aguero,huesca,14,6,34,62,162,278
22006,aisa,huesca,56,38,68,194,272,628
22007,albalate,huesca,334,150,264,710,880,2338
22008,albalatillo,huesca,40,28,72,122,164,426
22009,albelda,huesca,176,84,110,362,684,1416
22011,albero,huesca,36,26,16,74,104,256
22012,albero,huesca,30,20,8,72,94,224
22013,alberuela,huesca,40,18,72,142,292,564
22014,alcala,huesca,34,34,56,142,272,538
22015,alcala,huesca,84,42,60,208,350,744
22016,alcampell,huesca,122,54,96,316,686,1274
22017,alcolea,huesca,314,156,250,634,880,2234
22018,alcubierre,huesca,90,46,68,212,380,796
22019,alerre,huesca,68,28,28,126,200,450
22020,alfantega,huesca,26,8,30,76,122,262
22021,almudevar,huesca,820,330,434,1410,1876,4870
22022,almunia,huesca,210,96,138,416,566,1426
22023,almuniente,huesca,104,50,50,280,414,898
22024,alquezar,huesca,78,34,38,216,310,676
22025,altorricon,huesca,452,236,334,806,1108,2936
22027,angues,huesca,66,52,60,234,314,726
22028,anso,huesca,78,30,68,220,430,826
22029,antillon,huesca,26,10,20,72,126,254
22032,aragues,huesca,14,10,14,90,100,228
22035,aren,huesca,70,34,60,156,308,628
22036,argavieso,huesca,34,6,30,48,106,224
22037,arguis,huesca,48,10,28,98,146,330
22039,ayerbe,huesca,270,146,172,602,942,2132
22040,azanuy-alins,huesca,44,20,34,86,182,366
22041,azara,huesca,36,18,36,74,166,330
22042,azlor,huesca,46,24,28,88,128,314
22043,baells,huesca,22,4,12,48,96,182
22044,bailo,huesca,40,20,48,150,270,528
22045,baldellou,huesca,4,6,28,38,88,164
22046,ballobar,huesca,216,124,172,430,788,1730
22047,banastas,huesca,114,40,56,192,256,658
22048,barbastro,huesca,6138,2668,3754,10058,12498,35116
22049,barbues,huesca,10,8,24,32,106,180
22050,barbunales,huesca,8,4,16,34,128,190
22051,barcabo,huesca,16,2,20,56,150,244
22052,belver,huesca,368,182,274,770,1014,2608
22053,benabarre,huesca,346,138,180,638,978,2280
22054,benasque,huesca,776,348,574,1760,1274,4732
22055,berbegal,huesca,46,44,78,148,336,652
22057,bielsa,huesca,104,70,118,274,406,972
22058,bierge,huesca,44,20,46,144,226,480
22059,biescas,huesca,430,164,358,1074,1204,3230
22060,binaced,huesca,482,232,406,916,1194,3230
22061,binefar,huesca,3652,1706,2256,5940,6610,20164
22062,bisaurri,huesca,28,16,8,108,198,358
22063,biscarrues,huesca,16,14,46,86,214,376
22064,blecua,huesca,20,32,28,94,170,344
22066,boltana,huesca,300,146,226,742,794,2208
22067,bonansa,huesca,24,12,16,50,70,172
22068,borau,huesca,10,0,12,66,82,170
22069,broto,huesca,156,98,154,366,452,1226
22072,caldearenas,huesca,60,14,54,120,228,476
22074,campo,huesca,118,74,112,288,380,972
22075,camporrells,huesca,26,14,16,82,178,316
22076,canal,huesca,50,30,82,134,366,662
22077,candasnos,huesca,96,48,80,216,404,844
22078,canfranc,huesca,138,108,172,402,406,1226
22079,capdesaso,huesca,32,20,34,138,184,408
22080,capella,huesca,78,46,56,200,318,698
22081,casbas,huesca,32,32,36,166,318,584
22082,castejon,huesca,80,36,78,158,314,666
22083,castejon,huesca,56,44,80,228,528,936
22084,castejon,huesca,256,168,134,640,532,1730
22085,castelflorite,huesca,14,10,4,74,104,206
22086,castiello,huesca,70,22,58,168,212,530
22087,castigaleu,huesca,30,6,18,54,64,172
22088,castillazuelo,huesca,28,24,30,80,172,334
22089,castillonroy,huesca,86,28,54,198,294,660
22090,colungo,huesca,28,6,22,82,124,262
22094,chalamera,huesca,32,14,38,48,128,260
22095,chia,huesca,28,14,10,64,72,188
22096,chimillas,huesca,122,56,84,234,320,816
22099,esplus,huesca,162,90,132,366,574,1324
22102,estada,huesca,38,26,42,94,228,428
22103,estadilla,huesca,230,94,172,448,708,1652
22105,estopinan,huesca,34,26,30,60,122,272
22106,fago,huesca,0,2,6,12,30,50
22107,fanlo,huesca,24,0,16,70,126,236
22109,fiscal,huesca,102,44,70,260,290,766
22110,fonz,huesca,196,120,194,474,800,1784
22111,foradada,huesca,32,10,30,90,170,332
22112,fraga,huesca,5756,2306,3454,9708,9518,30742
22113,"fueva,",huesca,178,46,92,346,558,1220
22114,gistain,huesca,24,8,4,58,138,232
22115,"grado,",huesca,72,10,72,186,430,770
22116,granen,huesca,512,166,370,962,1402,3412
22117,graus,huesca,1004,464,690,1764,2816,6738
22119,gurrea,huesca,314,110,214,764,1444,2846
22122,hoz,huesca,6,12,12,44,82,156
22124,huerto,huesca,56,28,42,110,222,458
22125,huesca,huesca,19566,8376,11500,31228,38658,109328
22126,ibieca,huesca,14,8,16,44,128,210
22127,igries,huesca,310,134,136,472,426,1478
22128,ilche,huesca,10,18,24,110,214,376
22129,isabena,huesca,36,20,66,120,230,472
22130,jaca,huesca,4534,2022,3064,8252,9826,27698
22131,jasa,huesca,20,6,8,40,114,188
22133,labuerda,huesca,48,20,42,102,136,348
22135,laluenga,huesca,38,22,36,106,208,410
22136,lalueza,huesca,146,90,144,462,886,1728
22137,lanaja,huesca,204,102,232,542,1202,2282
22139,laperdiguera,huesca,8,8,12,46,102,176
22141,lascellas-ponzano,huesca,30,18,20,78,132,278
22142,lascuarre,huesca,44,6,22,68,130,270
22143,laspaules,huesca,46,32,46,166,216,506
22144,laspuna,huesca,56,22,56,162,258,554
22149,loarre,huesca,38,46,52,198,368,702
22150,loporzano,huesca,92,40,84,340,558,1114
22151,loscorrales,huesca,36,6,24,70,74,210
22155,monesma,huesca,4,2,12,36,84,138
22156,monflorite-lascasas,huesca,232,56,108,324,250,970
22157,montanuy,huesca,24,22,38,132,242,458
22158,monzon,huesca,6826,2852,3884,10634,12058,36254
22160,naval,huesca,80,24,46,166,228,544
22162,novales,huesca,46,18,32,100,138,334
22163,nueno,huesca,210,56,78,326,470,1140
22164,olvena,huesca,24,8,8,26,64,130
22165,ontinena,huesca,84,60,114,252,512,1022
22167,osso,huesca,130,62,154,348,620,1314
22168,palo,huesca,12,0,6,22,26,66
22170,panticosa,huesca,220,120,244,634,612,1830
22172,penalba,huesca,130,96,188,428,576,1418
22173,penas,huesca,42,20,48,146,280,536
22174,peralta,huesca,98,60,98,352,562,1170
22175,peralta,huesca,44,14,32,128,212,430
22176,peraltilla,huesca,62,14,56,108,188,428
22177,perarrua,huesca,30,6,14,66,108,224
22178,pertusa,huesca,24,24,24,80,120,272
22181,piraces,huesca,20,8,6,62,90,186
22182,plan,huesca,70,34,62,142,258,566
22184,polenino,huesca,38,14,36,102,206,396
22186,pozan,huesca,84,18,28,140,202,472
22187,puebla,huesca,130,52,80,258,340,860
22188,puente,huesca,16,6,20,50,100,192
22189,puertolas,huesca,68,16,40,160,168,452
22190,pueyo,huesca,50,22,36,102,132,342
22193,pueyo,huesca,88,40,70,176,274,648
22195,quicena,huesca,108,84,50,160,258,660
22197,robres,huesca,148,46,68,256,546,1064
22199,sabinanigo,huesca,2898,1248,1910,5530,7494,19080
22200,sahun,huesca,76,52,60,196,258,642
22201,salas,huesca,74,24,64,156,266,584
22202,salas,huesca,46,16,32,116,150,360
22203,salillas,huesca,18,14,12,60,96,200
22204,sallent,huesca,438,218,320,1068,1026,3070
22205,san,huesca,164,56,162,380,520,1282
22206,sangarren,huesca,46,14,30,144,212,446
22207,san,huesca,44,16,22,90,130,302
22208,santa,huesca,82,34,36,140,202,494
22209,santa,huesca,46,16,36,120,160,378
22212,santaliestra,huesca,12,8,12,44,92,168
22213,sarinena,huesca,1356,564,864,2324,3084,8192
22214,secastilla,huesca,42,6,20,84,144,296
22215,seira,huesca,26,12,24,80,150,292
22217,sena,huesca,134,56,98,236,426,950
22218,senes,huesca,4,10,10,24,56,104
22220,sesa,huesca,16,20,26,80,182,324
22221,sesue,huesca,50,10,18,90,64,232
22222,sietamo,huesca,224,74,138,440,492,1368
22223,sopeira,huesca,14,10,14,40,90,168
22225,tamarite,huesca,1068,458,708,1802,2812,6848
22226,tardienta,huesca,324,78,168,532,774,1876
22227,tella-sin,huesca,24,24,34,110,240,432
22228,tierz,huesca,418,134,112,638,340,1642
22229,tolva,huesca,26,6,30,52,150,264
22230,torla-ordesa,huesca,60,62,56,198,296,672
22232,torralba,huesca,28,12,22,54,92,208
22233,torre,huesca,22,8,18,62,92,202
22234,torrente,huesca,254,156,256,748,866,2280
22235,torres,huesca,8,4,22,44,106,184
22236,torres,huesca,46,14,52,150,284,546
22239,tramaced,huesca,16,14,24,66,102,222
22242,valfarta,huesca,6,4,0,32,68,110
22243,valle,huesca,4,6,24,22,56,112
22244,valle,huesca,8,8,2,28,68,114
22245,velilla,huesca,148,96,150,282,336,1012
22246,beranuy,huesca,6,6,2,30,94,138
22247,viacamp,huesca,8,2,10,26,36,82
22248,vicien,huesca,22,18,38,78,118,274
22249,villanova,huesca,58,30,20,130,100,338
22250,villanua,huesca,172,32,134,434,368,1140
22251,villanueva,huesca,64,46,90,162,330,692
22252,yebra,huesca,40,14,14,110,142,320
22253,yesero,huesca,6,4,4,34,76,124
22254,zaidin,huesca,480,298,418,1114,1260,3570
22901,valle,huesca,144,88,162,412,792,1598
22902,puente,huesca,58,40,40,154,236,528
22903,san,huesca,222,108,156,402,668,1556
22904,"sotonera,",huesca,174,92,128,480,926,1800
22905,lupinen-ortilla,huesca,90,42,52,220,294,698
22906,santa,huesca,38,18,48,82,230,416
22907,ainsa-sobrarbe,huesca,826,302,424,1504,1556,4612
22908,hoz,huesca,42,20,28,128,238,456
22909,vencillon,huesca,92,78,64,218,330,782
23001,albanchez,jaen,150,142,198,384,984,1858
23002,alcala,jaen,6906,3102,4828,11744,16640,43220
23003,alcaudete,jaen,3002,1490,2392,5618,8070,20572
23004,aldeaquemada,jaen,100,62,100,182,462,906
23005,andujar,jaen,11866,5388,7782,20520,25918,71474
23006,arjona,jaen,1718,810,1336,2882,4002,10748
23007,arjonilla,jaen,1020,526,926,1808,2780,7060
23008,arquillos,jaen,536,204,424,944,1262,3370
23009,baeza,jaen,5384,2316,3788,8944,10926,31358
23010,bailen,jaen,5700,2926,4014,10292,11592,34524
23011,banos,jaen,830,354,502,1410,2034,5130
23012,beas,jaen,1652,842,1012,2578,3864,9948
23014,begijar,jaen,870,446,724,1586,2268,5894
23015,belmez,jaen,414,228,330,736,1310,3018
23016,benatae,jaen,94,58,92,214,398,856
23017,cabra,jaen,480,266,358,848,1346,3298
23018,cambil,jaen,766,406,612,1378,2100,5262
23019,campillo,jaen,526,264,422,888,1304,3404
23020,canena,jaen,432,250,436,894,1496,3508
23021,carboneros,jaen,170,94,140,324,458,1186
23024,"carolina,",jaen,5150,2198,3076,8594,10400,29418
23025,castellar,jaen,1030,404,812,1586,2476,6308
23026,castillo,jaen,840,460,786,1718,3902,7706
23027,cazalilla,jaen,190,84,196,340,736,1546
23028,cazorla,jaen,2118,944,1488,3794,5664,14008
23029,chiclana,jaen,200,140,190,426,806,1762
23030,chilluevar,jaen,340,198,324,654,1126,2642
23031,escanuela,jaen,306,140,182,518,658,1804
23032,espeluy,jaen,164,102,134,292,492,1184
23033,frailes,jaen,400,240,306,786,1370,3102
23034,fuensanta,jaen,900,442,768,1568,2350,6028
23035,fuerte,jaen,388,232,344,758,960,2682
23037,genave,jaen,102,100,118,290,492,1102
23038,guardia,jaen,2108,1132,1156,3258,2834,10488
23039,guarroman,jaen,984,430,626,1600,1876,5516
23040,lahiguera,jaen,406,228,316,854,1374,3178
23041,higuera,jaen,220,70,132,286,472,1180
23042,hinojares,jaen,76,50,68,170,334,698
23043,hornos,jaen,138,98,136,294,492,1158
23044,huelma,jaen,1724,902,1204,2972,4240,11042
23045,huesa,jaen,788,348,522,1406,1770,4834
23046,ibros,jaen,768,486,670,1466,2144,5534
23047,"iruela,",jaen,472,244,472,1124,1410,3722
23048,iznatoraf,jaen,212,104,196,414,834,1760
23049,jabalquinto,jaen,526,300,464,1016,1622,3928
23050,jaen,jaen,37468,18474,25536,63700,78712,223890
23051,jamilena,jaen,1074,546,806,1840,2334,6600
23052,jimena,jaen,366,164,282,622,1046,2480
23053,jodar,jaen,4036,2000,2818,6648,7222,22724
23054,larva,jaen,146,88,78,264,304,880
23055,linares,jaen,18120,8524,11978,30438,41546,110606
23056,lopera,jaen,1054,558,830,1922,2714,7078
23057,lupion,jaen,210,94,184,406,714,1608
23058,mancha,jaen,4328,1874,2870,6632,7060,22764
23059,marmolejo,jaen,1904,930,1580,3526,5102,13042
23060,martos,jaen,8578,3780,6422,13854,16212,48846
23061,mengibar,jaen,4060,1726,2628,5848,5808,20070
23062,montizon,jaen,416,236,350,796,1392,3190
23063,navas,jaen,1466,672,998,2492,3210,8838
23064,noalejo,jaen,410,298,412,874,1596,3590
23065,orcera,jaen,444,268,400,896,1422,3430
23066,peal,jaen,1624,742,1284,2872,4022,10544
23067,pegalajar,jaen,860,408,670,1536,2190,5664
23069,porcuna,jaen,1528,896,1400,2976,5000,11800
23070,pozo,jaen,1424,734,1014,2322,3672,9166
23071,puente,jaen,798,296,470,1244,1552,4360
23072,puerta,jaen,666,330,486,1138,1870,4490
23073,quesada,jaen,1356,736,1164,2506,4138,9900
23074,rus,jaen,998,542,796,1850,2638,6824
23075,sabiote,jaen,1202,618,782,2080,2878,7560
23076,santa,jaen,198,128,178,482,750,1736
23077,santiago,jaen,152,104,130,380,578,1344
23079,santisteban,jaen,1498,722,1128,2442,3120,8910
23080,santo,jaen,626,340,456,1098,1622,4142
23081,segura,jaen,494,242,366,860,1408,3370
23082,siles,jaen,598,278,414,1140,1786,4216
23084,sorihuela,jaen,306,150,232,510,874,2072
23085,torreblascopedro,jaen,580,388,542,1296,2002,4808
23086,torredelcampo,jaen,4740,2174,3554,8000,9406,27874
23087,torredonjimeno,jaen,4322,1810,3144,7556,9684,26516
23088,torreperogil,jaen,2174,1078,1610,3980,5388,14230
23090,torres,jaen,364,128,330,654,1220,2696
23091,torres,jaen,180,116,244,364,582,1486
23092,ubeda,jaen,11032,5336,7558,19146,24258,67330
23093,valdepenas,jaen,964,524,830,1860,2930,7108
23094,vilches,jaen,1196,532,888,2438,3372,8426
23095,villacarrillo,jaen,3332,1610,2476,5536,7704,20658
23096,villanueva,jaen,828,430,744,1548,2380,5930
23097,villanueva,jaen,2606,1266,1800,4170,5716,15558
23098,villardompardo,jaen,180,132,244,420,872,1848
23099,"villares,",jaen,2182,976,1404,3734,3870,12166
23101,villarrodrigo,jaen,64,68,44,194,418,788
23901,carcheles,jaen,338,184,310,662,1084,2578
23902,bedmar,jaen,722,460,556,1324,2080,5142
23903,villatorres,jaen,1468,666,1032,2402,2976,8544
23904,santiago-pontones,jaen,594,370,614,1272,2550,5400
23905,arroyo,jaen,640,366,438,1204,1718,4366
24001,acebedo,leon,20,36,20,80,220,376
24002,algadefe,leon,76,42,68,152,266,604
24003,alija,leon,50,46,72,236,738,1142
24004,almanza,leon,132,38,120,336,580,1206
24005,"antigua,",leon,32,18,32,154,418,654
24006,ardon,leon,102,38,92,268,594,1094
24007,arganza,leon,156,80,122,420,838,1616
24008,astorga,leon,2738,1314,1680,5416,9436,20584
24009,balboa,leon,42,12,20,106,350,530
24010,"baneza,",leon,3046,1424,1964,5602,8238,20274
24011,barjas,leon,6,2,10,82,194,294
24012,barrios,leon,34,22,28,176,324,584
24014,bembibre,leon,1850,1072,1456,4506,7514,16398
24015,benavides,leon,394,252,440,1150,2444,4680
24016,benuza,leon,46,24,88,234,512,904
24017,bercianos,leon,42,46,78,214,666,1046
24018,bercianos,leon,28,6,32,96,212,374
24019,berlanga,leon,28,18,58,168,374,646
24020,boca,leon,34,36,58,238,486,852
24021,bonar,leon,310,170,292,906,1852,3530
24022,borrenes,leon,16,8,38,138,404,604
24023,brazuelo,leon,60,36,56,156,328,636
24024,burgo,leon,120,56,114,320,772,1382
24025,buron,leon,28,24,50,136,338,576
24026,bustillo,leon,102,54,168,492,1298,2114
24027,cabanas,leon,280,108,218,758,1254,2618
24028,cabreros,leon,86,30,44,212,446,818
24029,cabrillanes,leon,80,62,126,348,804,1420
24030,cacabelos,leon,1226,632,722,2692,4226,9498
24031,calzada,leon,34,18,42,84,270,448
24032,campazas,leon,20,12,20,44,124,220
24033,campo,leon,20,16,28,100,240,404
24034,camponaraya,leon,1086,530,758,2590,3254,8218
24036,valle,leon,8,26,70,114,332,550
24037,carmenes,leon,22,32,14,190,408,666
24038,carracedelo,leon,736,276,500,1878,3466,6856
24039,carrizo,leon,502,190,448,1164,2142,4446
24040,carrocera,leon,54,38,74,238,476,880
24041,carucedo,leon,40,38,58,230,600,966
24042,castilfale,leon,4,2,8,26,82,122
24043,castrillo,leon,0,0,20,28,156,204
24044,castrillo,leon,14,2,8,64,198,286
24046,castrocalbon,leon,122,84,142,406,1076,1830
24047,castrocontrigo,leon,52,44,106,252,884,1338
24049,castropodame,leon,304,160,252,842,1602,3160
24050,castrotierra,leon,18,16,18,36,122,210
24051,cea,leon,52,24,64,152,464,756
24052,cebanico,leon,4,6,32,62,186,290
24053,cebrones,leon,66,48,70,218,474,876
24054,cimanes,leon,82,30,86,230,466,894
24055,cimanes,leon,120,44,116,334,870,1484
24056,cistierna,leon,570,308,394,1392,3142,5806
24057,congosto,leon,262,132,228,788,1450,2860
24058,corbillos,leon,22,10,32,72,218,354
24059,corullon,leon,82,52,114,358,1064,1670
24060,cremenes,leon,42,42,104,244,604,1036
24061,cuadros,leon,550,242,276,1324,1806,4198
24062,cubillas,leon,8,18,28,32,188,274
24063,cubillas,leon,32,26,66,140,510,774
24064,cubillos,leon,458,180,292,1112,1400,3442
24065,chozas,leon,812,266,412,1788,2120,5398
24066,destriana,leon,34,24,62,168,570,858
24067,encinedo,leon,100,60,138,348,628,1274
24068,"ercina,",leon,28,32,42,166,596,864
24069,escobar,leon,0,6,4,4,48,62
24070,fabero,leon,756,384,692,2122,4160,8114
24071,folgoso,leon,180,104,152,524,1000,1960
24073,fresno,leon,64,48,86,182,580,960
24074,fuentes,leon,10,2,6,28,106,152
24076,garrafe,leon,420,166,254,1056,1380,3276
24077,gordaliza,leon,52,22,30,94,282,480
24078,gordoncillo,leon,54,16,46,130,370,616
24079,gradefes,leon,132,66,96,460,1094,1848
24080,grajal,leon,16,24,32,88,264,424
24081,gusendos,leon,18,8,20,58,148,252
24082,hospital,leon,206,110,158,500,944,1918
24083,iguena,leon,142,80,154,558,1170,2104
24084,izagre,leon,0,8,22,40,208,278
24086,joarilla,leon,38,2,30,122,304,496
24087,laguna,leon,134,22,88,318,686,1248
24088,laguna,leon,164,76,172,490,1192,2094
24089,leon,leon,33580,16192,22418,65546,107996,245732
24090,lucillo,leon,48,50,56,156,410,720
24091,luyego,leon,58,38,66,228,722,1112
24092,llamas,leon,136,64,96,372,914,1582
24093,magaz,leon,34,20,50,148,446,698
24094,mansilla,leon,476,180,318,986,1360,3320
24095,mansilla,leon,30,38,66,158,358,650
24096,marana,leon,14,14,16,60,120,224
24097,matadeon,leon,42,30,38,104,228,442
24098,matallana,leon,218,96,180,720,1254,2468
24099,matanza,leon,26,18,34,80,192,350
24100,molinaseca,leon,226,104,130,532,746,1738
24101,murias,leon,26,6,42,172,434,680
24102,noceda,leon,78,62,58,270,742,1210
24103,oencia,leon,14,22,48,112,364,560
24104,"omanas,",leon,28,18,30,128,318,522
24105,onzonilla,leon,614,250,274,1254,1498,3890
24106,oseja,leon,36,16,32,112,260,456
24107,pajares,leon,36,10,36,136,262,480
24108,palacios,leon,52,30,60,144,426,712
24109,palacios,leon,100,50,106,444,994,1694
24110,paramo,leon,184,54,228,570,1310,2346
24112,peranzanes,leon,12,12,28,118,372,542
24113,pobladura,leon,52,24,38,172,436,722
24114,pola,leon,428,198,402,1386,3298,5712
24115,ponferrada,leon,17072,8106,10718,36116,53902,125914
24116,posada,leon,44,26,58,176,504,808
24117,pozuelo,leon,44,22,40,154,528,788
24118,prado,leon,8,8,16,42,134,208
24119,priaranza,leon,104,38,112,360,810,1424
24120,prioro,leon,80,24,50,166,382,702
24121,puebla,leon,138,80,78,402,608,1306
24122,puente,leon,266,172,284,738,1350,2810
24123,quintana,leon,62,28,110,290,938,1428
24124,quintana,leon,26,18,30,116,436,626
24125,quintana,leon,40,26,48,194,532,840
24127,regueras,leon,46,8,58,94,322,528
24129,reyero,leon,2,10,26,74,142,254
24130,riano,leon,102,26,100,246,484,958
24131,riego,leon,128,46,114,346,800,1434
24132,riello,leon,42,26,86,236,780,1170
24133,rioseco,leon,44,32,64,186,470,796
24134,"robla,",leon,768,358,626,1998,3508,7258
24136,roperuelos,leon,72,30,60,240,602,1004
24137,sabero,leon,106,102,128,504,1208,2048
24139,sahagun,leon,576,240,370,1156,2444,4786
24141,san,leon,4,12,0,48,104,168
24142,san,leon,8970,4182,5552,18186,22956,59846
24143,sancedo,leon,96,62,70,288,540,1056
24144,san,leon,100,56,80,310,700,1246
24145,san,leon,50,42,116,300,686,1194
24146,san,leon,10,12,30,94,338,484
24148,san,leon,376,222,306,1006,1648,3558
24149,san,leon,46,10,46,94,186,382
24150,san,leon,20,12,40,92,284,448
24151,santa,leon,68,30,68,268,580,1014
24152,santa,leon,74,46,64,266,536,986
24153,santa,leon,36,28,64,116,310,554
24154,santa,leon,190,76,172,508,1090,2036
24155,santa,leon,44,26,48,192,576,886
24156,santa,leon,12,10,26,64,306,418
24157,santa,leon,784,336,612,1586,2692,6010
24158,santa,leon,34,12,58,174,372,650
24159,santa,leon,290,100,264,828,2002,3484
24160,santas,leon,126,76,132,386,784,1504
24161,santiago,leon,64,72,58,202,330,726
24162,santovenia,leon,598,244,382,1236,1684,4144
24163,sariegos,leon,2024,700,898,3342,3944,10908
24164,sena,leon,36,38,84,202,416,776
24165,sobrado,leon,14,4,16,136,394,564
24166,soto,leon,300,176,218,736,1560,2990
24167,soto,leon,106,56,92,340,836,1430
24168,toral,leon,94,34,78,258,532,996
24169,toreno,leon,454,278,498,1522,2984,5736
24170,torre,leon,308,188,354,994,2098,3942
24171,trabadelo,leon,16,20,68,178,382,664
24172,truchas,leon,28,54,64,154,482,782
24173,turcia,leon,190,76,130,484,1092,1972
24174,urdiales,leon,44,48,56,214,542,904
24175,valdefresno,leon,692,256,320,1432,1964,4664
24176,valdefuentes,leon,36,26,44,132,374,612
24177,valdelugueros,leon,78,64,76,262,492,972
24178,valdemora,leon,4,6,2,30,80,122
24179,valdepielago,leon,46,28,38,192,310,614
24180,valdepolo,leon,188,88,180,644,1322,2422
24181,valderas,leon,308,214,246,734,1514,3016
24182,valderrey,leon,52,30,64,198,490,834
24183,valderrueda,leon,110,54,122,398,956,1640
24184,valdesamario,leon,8,10,20,82,230,350
24185,val,leon,98,20,90,222,554,984
24187,valdevimbre,leon,118,112,154,502,948,1834
24188,valencia,leon,1690,688,1052,3116,3772,10318
24189,valverde,leon,2744,1120,1982,5224,4534,15604
24190,valverde-enrique,leon,16,10,10,86,182,304
24191,vallecillo,leon,16,6,14,58,112,206
24193,"vecilla,",leon,34,28,54,220,426,762
24194,vegacervera,leon,24,18,60,126,290,518
24196,vega,leon,324,144,358,918,2266,4010
24197,vega,leon,170,90,116,468,838,1682
24198,vega,leon,62,38,78,302,626,1106
24199,vegaquemada,leon,54,24,56,206,530,870
24201,vegas,leon,214,60,172,636,1234,2316
24202,villablino,leon,1258,890,1110,4182,7998,15438
24203,villabraz,leon,12,18,12,46,102,190
24205,villadangos,leon,328,136,232,792,982,2470
24206,toral,leon,328,164,260,1020,1736,3508
24207,villademor,leon,36,30,52,148,316,582
24209,villafranca,leon,438,236,384,1242,3058,5358
24210,villagaton,leon,92,44,132,376,646,1290
24211,villamandos,leon,50,18,46,138,300,552
24212,villamanan,leon,176,72,164,518,1224,2154
24213,villamartin,leon,16,6,20,82,172,296
24214,villamejil,leon,96,38,84,308,782,1308
24215,villamol,leon,12,20,18,82,140,272
24216,villamontan,leon,96,54,82,268,866,1366
24217,villamoratiel,leon,18,2,14,58,150,242
24218,villanueva,leon,78,42,52,278,556,1006
24219,villaobispo,leon,108,42,78,252,554,1034
24221,villaquejida,leon,162,104,118,436,790,1610
24222,villaquilambre,leon,6844,2694,3190,13516,11176,37420
24223,villarejo,leon,694,300,494,1488,2778,5754
24224,villares,leon,24,36,98,208,756,1122
24225,villasabariego,leon,288,104,202,658,1042,2294
24226,villaselan,leon,22,14,26,94,208,364
24227,villaturiel,leon,470,198,272,1108,1616,3664
24228,villazala,leon,70,44,92,258,732,1196
24229,villazanzo,leon,38,44,24,164,464,734
24230,zotes,leon,44,18,52,200,488,802
24901,villamanin,leon,120,74,128,516,918,1756
24902,villaornate,leon,48,18,56,182,400,704
25001,abella,lleida,28,24,34,106,130,322
25002,àger,lleida,134,62,108,346,566,1216
25003,agramunt,lleida,2088,912,1144,3158,3882,11184
25004,"alamus,",lleida,224,114,204,492,564,1598
25005,alàs,lleida,106,38,64,152,290,650
25006,"albages,",lleida,56,42,60,182,346,686
25007,albatàrrec,lleida,828,344,520,1626,1176,4494
25008,albesa,lleida,516,218,342,928,1138,3142
25009,"albi,",lleida,240,110,110,404,664,1528
25010,alcano,lleida,78,24,50,136,192,480
25011,alcarràs,lleida,4136,1514,2348,7264,5172,20434
25012,alcoletge,lleida,1466,434,872,2506,1964,7242
25013,alfarràs,lleida,868,456,500,1532,2162,5518
25014,alfes,lleida,82,28,50,150,258,568
25015,algerri,lleida,104,54,94,196,404,852
25016,alguaire,lleida,958,436,548,1808,2234,5984
25017,alins,lleida,58,38,36,176,242,550
25019,almacelles,lleida,2368,1294,1576,4120,4704,14062
25020,almatret,lleida,40,26,70,132,338,606
25021,almenar,lleida,988,478,644,1980,2552,6642
25022,alòs,lleida,14,20,14,76,112,236
25023,alpicat,lleida,2646,1118,1272,3934,3962,12932
25024,alt,lleida,108,46,126,244,390,914
25025,naut,lleida,604,256,444,1306,1182,3792
25027,anglesola,lleida,500,158,210,882,990,2740
25029,arbeca,lleida,600,264,442,1118,1746,4170
25030,pont,lleida,44,20,26,96,144,330
25031,arres,lleida,10,4,26,40,46,126
25032,arseguel,lleida,24,12,6,52,62,156
25033,artesa,lleida,428,268,282,942,1152,3072
25034,artesa,lleida,1178,542,780,2064,2474,7038
25035,sentiu,lleida,124,40,92,238,414,908
25036,aspa,lleida,62,28,44,108,196,438
25037,avellanes,lleida,110,36,76,236,402,860
25038,aitona,lleida,952,370,528,1554,1746,5150
25039,baix,lleida,76,54,68,166,324,688
25040,balaguer,lleida,6850,2858,4082,10208,11196,35194
25041,barbens,lleida,238,152,206,588,632,1816
25042,baronia,lleida,46,28,48,110,228,460
25043,vall,lleida,320,128,252,772,766,2238
25044,bassella,lleida,52,26,44,120,178,420
25045,bausen,lleida,8,2,10,40,60,120
25046,belianes,lleida,132,76,132,178,518,1036
25047,bellcaire,lleida,352,176,268,642,1014,2452
25048,bell-lloc,lleida,800,400,492,1330,1672,4694
25049,bellmunt,lleida,54,30,34,102,146,366
25050,bellpuig,lleida,1766,878,1292,3168,3388,10492
25051,bellver,lleida,730,278,470,1462,1592,4532
25052,bellvis,lleida,702,312,468,1308,1712,4502
25053,benavent,lleida,546,308,306,1026,956,3142
25055,biosca,lleida,32,16,40,88,178,354
25056,bovera,lleida,54,28,32,116,276,506
25057,"bòrdes,",lleida,72,26,48,224,192,562
25058,borges,lleida,2324,908,1306,3674,4468,12680
25059,bossòst,lleida,362,182,262,678,804,2288
25060,cabanabona,lleida,8,4,14,32,72,130
25061,cabo,lleida,22,8,18,50,84,182
25062,camarasa,lleida,206,76,144,480,730,1636
25063,canejan,lleida,20,10,24,66,82,202
25064,castellar,lleida,68,28,12,86,94,288
25067,castelldans,lleida,248,96,186,514,738,1782
25068,castellnou,lleida,248,94,146,402,566,1456
25069,castello,lleida,180,66,118,262,460,1086
25070,castellserà,lleida,262,140,162,508,912,1984
25071,cava,lleida,6,0,2,24,48,80
25072,cervera,lleida,3626,1742,2146,5498,6094,19106
25073,cervià,lleida,148,84,108,346,594,1280
25074,ciutadilla,lleida,36,30,32,112,178,388
25075,clariana,lleida,60,16,40,88,116,320
25076,"cogul,",lleida,30,22,38,76,158,324
25077,coll,lleida,134,62,144,344,482,1166
25078,corbins,lleida,514,246,274,958,974,2966
25079,cubells,lleida,72,20,88,166,338,684
25081,espluga,lleida,90,28,48,186,312,664
25082,espot,lleida,80,68,78,212,320,758
25085,estaràs,lleida,48,16,28,94,138,324
25086,esterri,lleida,290,176,248,562,564,1840
25087,esterri,lleida,26,2,8,42,48,126
25088,estamariu,lleida,38,26,8,72,122,266
25089,farrera,lleida,28,14,32,78,104,256
25092,"floresta,",lleida,36,28,34,78,152,328
25093,fondarella,lleida,292,110,152,498,562,1614
25094,foradada,lleida,72,18,34,120,156,400
25096,"fuliola,",lleida,440,212,236,698,912,2498
25097,fulleda,lleida,8,10,18,42,106,184
25098,gavet,lleida,46,16,40,132,290,524
25099,golmes,lleida,716,308,364,1198,1240,3826
25100,gosol,lleida,52,20,44,110,202,428
25101,"granadella,",lleida,184,98,194,416,632,1524
25102,granja,lleida,254,92,204,586,746,1882
25103,granyanella,lleida,28,16,18,80,138,280
25104,granyena,lleida,46,16,14,88,130,294
25105,granyena,lleida,44,16,16,92,160,328
25109,guimerà,lleida,52,24,44,118,260,498
25110,guissona,lleida,3342,1474,1932,5112,3312,15172
25111,guixers,lleida,28,18,14,80,130,270
25112,ivars,lleida,74,46,54,168,296,638
25113,ivars,lleida,512,190,320,910,1250,3182
25114,ivorra,lleida,10,16,18,46,114,204
25115,isona,lleida,286,114,202,496,986,2084
25118,juncosa,lleida,90,46,96,198,348,778
25119,juneda,lleida,1256,526,720,2136,2408,7046
25120,lleida,lleida,50802,23786,33942,87208,94018,289756
25121,les,lleida,288,178,276,678,642,2062
25122,linyola,lleida,1004,400,534,1600,1936,5474
25123,lladorre,lleida,60,32,66,110,240,508
25124,lladurs,lleida,50,18,36,110,156,370
25125,llardecans,lleida,102,40,96,192,424,854
25126,llavorsi,lleida,88,32,62,208,282,672
25127,lles,lleida,66,44,50,162,254,576
25128,llimiana,lleida,20,6,22,72,144,264
25129,llobera,lleida,64,26,36,110,180,416
25130,maldà,lleida,46,22,44,144,222,478
25131,massalcoreig,lleida,162,86,130,302,472,1152
25132,massoteres,lleida,78,48,46,140,112,424
25133,maials,lleida,218,132,220,470,792,1832
25134,menàrguens,lleida,180,110,188,378,730,1586
25135,miralcamp,lleida,518,212,252,832,964,2778
25136,"molsosa,",lleida,20,8,28,34,120,210
25137,mollerussa,lleida,6426,2646,3570,9888,8830,31360
25138,montgai,lleida,148,78,116,314,624,1280
25139,montellà,lleida,174,52,126,366,520,1238
25140,montferrer,lleida,410,124,214,820,758,2326
25141,montoliu,lleida,46,26,16,122,152,362
25142,montoliu,lleida,164,82,60,292,356,954
25143,montornes,lleida,14,12,10,50,90,176
25145,nalec,lleida,20,4,12,56,86,178
25146,naves,lleida,102,44,40,198,220,604
25148,oden,lleida,38,14,44,122,244,462
25149,oliana,lleida,502,230,410,916,1598,3656
25150,oliola,lleida,34,30,36,84,206,390
25151,olius,lleida,446,154,158,636,612,2006
25152,"oluges,",lleida,30,16,16,100,168,330
25153,"omellons,",lleida,40,12,30,84,212,378
25154,omells,lleida,16,16,20,72,118,242
25155,organyà,lleida,220,100,178,412,708,1618
25156,os,lleida,348,190,220,610,776,2144
25157,osso,lleida,66,20,28,100,176,390
25158,palau,lleida,796,288,480,1316,1520,4400
25161,conca,lleida,134,40,60,240,396,870
25163,coma,lleida,62,36,60,156,252,566
25164,penelles,lleida,100,48,76,200,446,870
25165,peramola,lleida,90,38,86,174,310,698
25166,pinell,lleida,46,18,48,116,178,406
25167,pinos,lleida,94,36,42,168,214,554
25168,"poal,",lleida,206,98,116,352,532,1304
25169,pobla,lleida,26,34,24,94,240,418
25170,bellaguarda,lleida,64,30,72,126,298,590
25171,pobla,lleida,906,408,778,1558,2436,6086
25172,ponts,lleida,870,386,654,1502,1928,5340
25173,pont,lleida,766,380,548,1478,1658,4830
25174,"portella,",lleida,194,110,144,520,478,1446
25175,prats,lleida,58,28,64,144,214,508
25176,preixana,lleida,124,44,56,232,352,808
25177,preixens,lleida,94,50,66,180,390,780
25179,prullans,lleida,76,40,34,158,196,504
25180,puiggròs,lleida,68,28,40,140,238,514
25181,puigverd,lleida,72,30,58,148,186,494
25182,puigverd,lleida,488,238,282,922,904,2834
25183,rialp,lleida,184,76,172,452,442,1326
25185,ribera,lleida,316,138,178,654,634,1920
25186,riner,lleida,104,24,42,138,220,528
25189,rossello,lleida,1290,488,766,2254,1908,6706
25190,salàs,lleida,98,30,56,242,282,708
25191,sanauja,lleida,76,72,66,212,348,774
25192,sant,lleida,444,152,252,744,836,2428
25193,sant,lleida,282,130,180,544,864,2000
25194,sant,lleida,118,52,86,264,470,990
25196,sant,lleida,12,16,18,62,140,248
25197,sant,lleida,48,42,36,104,160,390
25200,sarroca,lleida,90,34,70,202,366,762
25201,sarroca,lleida,14,4,24,56,130,228
25202,senterada,lleida,42,10,22,124,116,314
25203,seu,lleida,4064,1996,3148,7382,8928,25518
25204,seròs,lleida,672,224,414,1170,1300,3780
25205,sidamon,lleida,296,104,140,500,498,1538
25206,"soleràs,",lleida,74,38,52,160,310,634
25207,solsona,lleida,3342,1626,2062,5454,6302,18786
25208,soriguera,lleida,154,52,118,318,252,894
25209,sort,lleida,728,348,482,1392,1566,4516
25210,soses,lleida,748,250,362,1134,1246,3740
25211,sudanell,lleida,244,108,160,570,712,1794
25212,sunyer,lleida,104,38,82,162,226,612
25215,talarn,lleida,128,96,202,364,292,1082
25216,talavera,lleida,74,44,50,134,268,570
25217,tàrrega,lleida,7542,3106,4400,11044,11048,37140
25218,tarres,lleida,52,16,18,64,100,250
25219,tarroja,lleida,50,20,18,110,146,344
25220,termens,lleida,396,194,262,822,1014,2688
25221,tirvia,lleida,38,8,30,84,128,288
25222,tiurana,lleida,14,6,12,40,62,134
25223,torà,lleida,354,166,296,672,1018,2506
25224,"torms,",lleida,24,34,12,48,158,276
25225,tornabous,lleida,282,102,176,498,626,1684
25226,torrebesses,lleida,70,28,52,148,248,546
25227,torre,lleida,178,58,140,430,768,1574
25228,torrefarrera,lleida,2120,822,928,3472,2466,9808
25230,torregrossa,lleida,736,310,488,1144,1776,4454
25231,torrelameu,lleida,238,78,202,564,516,1598
25232,torres,lleida,730,306,552,1406,1542,4536
25233,torre-serona,lleida,122,74,56,304,324,880
25234,tremp,lleida,1840,966,1310,3302,4694,12112
25238,vallbona,lleida,38,28,32,116,228,442
25239,valls,lleida,272,74,168,522,584,1620
25240,vallfogona,lleida,790,252,360,1272,1358,4032
25242,verdu,lleida,200,128,216,408,818,1770
25243,vielha,lleida,1764,798,1520,4002,3502,11586
25244,vilagrassa,lleida,264,90,142,400,370,1266
25245,vilaller,lleida,120,58,80,338,416,1012
25247,vilamòs,lleida,28,20,42,120,142,352
25248,vilanova,lleida,464,114,172,634,952,2336
25249,vilanova,lleida,38,30,24,76,222,390
25250,vilanova,lleida,202,64,60,234,364,924
25251,vilanova,lleida,358,110,234,722,690,2114
25252,vila-sana,lleida,284,84,156,484,480,1488
25253,"vilosell,",lleida,38,18,38,100,190,384
25254,vilanova,lleida,312,112,262,724,790,2200
25255,vinaixa,lleida,108,38,70,228,454,898
25901,vall,lleida,82,42,78,216,344,762
25902,sant,lleida,200,66,106,364,614,1350
25903,guingueta,lleida,56,30,62,164,254,566
25904,castell,lleida,30,14,44,84,178,350
25905,ribera,lleida,116,40,100,252,400,908
25906,valls,lleida,44,28,36,146,284,538
25907,torrefeta,lleida,160,72,130,358,496,1216
25908,figols,lleida,38,18,34,160,238,488
25909,vansa,lleida,24,18,36,108,192,378
25910,josa,lleida,28,8,24,72,114,246
25911,plans,lleida,130,76,98,264,474,1042
25912,gimenells,lleida,346,160,200,652,832,2190
25913,riu,lleida,12,14,10,60,102,198
26001,abalos,"rioja,",70,36,54,114,244,518
26002,agoncillo,"rioja,",374,182,310,876,882,2624
26003,aguilar,"rioja,",90,52,66,202,456,866
26004,ajamil,"rioja,",4,0,22,50,94,170
26005,albelda,"rioja,",1390,558,830,2374,2596,7748
26006,alberite,"rioja,",916,360,576,1698,1822,5372
26007,alcanadre,"rioja,",140,102,148,354,550,1294
26008,aldeanueva,"rioja,",932,458,564,1516,1958,5428
26009,alesanco,"rioja,",126,56,78,240,456,956
26010,aleson,"rioja,",20,16,8,48,100,192
26011,alfaro,"rioja,",3450,1292,1964,5666,7356,19728
26012,almarza,"rioja,",12,2,4,34,28,80
26013,anguciana,"rioja,",110,68,86,270,318,852
26014,anguiano,"rioja,",100,40,64,214,562,980
26015,arenzana,"rioja,",64,40,42,130,232,508
26016,arenzana,"rioja,",0,4,2,18,46,70
26017,arnedillo,"rioja,",86,48,92,240,396,862
26018,arnedo,"rioja,",5340,2276,3022,8850,10806,30294
26019,arrubal,"rioja,",176,66,148,378,386,1154
26020,ausejo,"rioja,",296,98,198,468,554,1614
26021,autol,"rioja,",2034,678,1122,3030,2846,9710
26022,azofra,"rioja,",28,12,32,80,250,402
26023,badaran,"rioja,",84,54,90,224,534,986
26024,banares,"rioja,",32,18,30,86,232,398
26025,banos,"rioja,",10,4,22,32,102,170
26026,banos,"rioja,",490,216,328,874,1308,3216
26027,berceo,"rioja,",14,10,32,54,166,276
26028,bergasa,"rioja,",32,12,22,114,160,340
26029,bergasillas,"rioja,",0,0,4,20,52,76
26030,bezares,"rioja,",2,2,8,8,22,42
26031,bobadilla,"rioja,",16,8,16,38,124,202
26032,brieva,"rioja,",0,0,8,16,52,76
26033,brinas,"rioja,",40,38,48,80,170,376
26034,briones,"rioja,",190,92,90,436,694,1502
26035,cabezon,"rioja,",0,12,0,20,12,44
26036,calahorra,"rioja,",8936,3896,5862,14832,16626,50152
26037,camprovin,"rioja,",18,28,30,74,168,318
26038,canales,"rioja,",4,4,8,44,104,164
26039,canillas,"rioja,",10,2,2,26,46,86
26040,canas,"rioja,",20,24,26,40,84,194
26041,cardenas,"rioja,",14,14,26,52,150,256
26042,casalarreina,"rioja,",312,144,240,552,872,2120
26043,castanares,"rioja,",60,50,60,202,436,808
26044,castroviejo,"rioja,",4,6,18,32,60,120
26045,cellorigo,"rioja,",0,0,0,2,18,20
26046,cenicero,"rioja,",668,250,406,1232,1640,4196
26047,cervera,"rioja,",510,314,422,1156,2150,4552
26048,cidamon,"rioja,",4,0,0,14,16,34
26049,cihuri,"rioja,",44,24,36,112,184,400
26050,ciruena,"rioja,",52,20,36,116,160,384
26051,clavijo,"rioja,",104,32,32,184,242,594
26052,cordovin,"rioja,",14,10,20,64,210,318
26053,corera,"rioja,",68,30,66,124,262,550
26054,cornago,"rioja,",34,20,46,104,376,580
26055,corporales,"rioja,",0,8,0,24,52,84
26056,cuzcurrita,"rioja,",144,64,128,326,460,1122
26057,daroca,"rioja,",10,14,8,40,60,132
26058,enciso,"rioja,",14,16,22,80,210,342
26059,entrena,"rioja,",574,224,344,1066,1058,3266
26060,estollo,"rioja,",4,8,10,36,114,172
26061,ezcaray,"rioja,",524,324,426,1120,1786,4180
26062,foncea,"rioja,",22,8,12,56,88,186
26063,fonzaleche,"rioja,",20,12,34,64,126,256
26064,fuenmayor,"rioja,",1176,516,590,2076,2188,6546
26065,galbarruli,"rioja,",12,8,20,36,74,150
26066,galilea,"rioja,",120,72,62,244,314,812
26067,gallinero,"rioja,",0,4,4,8,16,32
26068,gimileo,"rioja,",52,14,22,76,84,248
26069,granon,"rioja,",28,14,24,108,270,444
26070,gravalos,"rioja,",46,16,54,78,178,372
26071,haro,"rioja,",4026,1830,2354,7106,8620,23936
26072,herce,"rioja,",58,58,62,162,326,666
26073,herramelluri,"rioja,",12,22,16,36,132,218
26074,hervias,"rioja,",24,16,10,94,136,280
26075,hormilla,"rioja,",148,68,76,210,368,870
26076,hormilleja,"rioja,",32,4,22,56,160,274
26077,hornillos,"rioja,",0,0,0,8,16,24
26078,hornos,"rioja,",16,10,12,54,106,198
26079,huercanos,"rioja,",268,132,126,430,736,1692
26080,igea,"rioja,",184,136,130,316,546,1312
26081,jalon,"rioja,",4,2,6,10,24,46
26082,laguna,"rioja,",0,26,10,32,162,230
26083,lagunilla,"rioja,",54,46,82,172,430,784
26084,lardero,"rioja,",4806,1756,2504,8368,5998,23432
26086,ledesma,"rioja,",0,0,6,6,20,32
26087,leiva,"rioja,",26,50,40,130,244,490
26088,leza,"rioja,",0,4,12,24,46,86
26089,logrono,"rioja,",49870,21950,29588,88794,111488,301690
26091,lumbreras,"rioja,",6,6,12,82,190,296
26092,manjarres,"rioja,",10,6,22,54,124,216
26093,mansilla,"rioja,",4,14,16,28,64,126
26094,manzanares,"rioja,",0,0,6,18,98,122
26095,matute,"rioja,",6,6,14,30,124,180
26096,medrano,"rioja,",126,34,58,232,262,712
26098,munilla,"rioja,",10,12,18,56,100,196
26099,murillo,"rioja,",556,250,290,988,1270,3354
26100,muro,"rioja,",0,2,14,30,62,108
26101,muro,"rioja,",0,0,6,16,52,74
26102,najera,"rioja,",2744,1240,1650,4718,5958,16310
26103,nalda,"rioja,",368,172,248,822,1016,2626
26104,navajun,"rioja,",0,0,2,4,10,16
26105,navarrete,"rioja,",1114,460,538,1994,1960,6066
26106,nestares,"rioja,",4,8,18,42,98,170
26107,nieva,"rioja,",8,4,10,44,108,174
26108,ocon,"rioja,",36,18,56,154,410,674
26109,ochanduri,"rioja,",10,10,14,26,104,164
26110,ojacastro,"rioja,",24,12,42,64,216,358
26111,ollauri,"rioja,",96,30,36,192,274,628
26112,ortigosa,"rioja,",14,14,46,88,270,432
26113,pazuengos,"rioja,",0,4,0,12,34,50
26114,pedroso,"rioja,",6,6,12,44,110,178
26115,pinillos,"rioja,",0,0,0,14,24,38
26117,pradejon,"rioja,",1354,600,920,2364,2232,7470
26118,pradillo,"rioja,",0,8,14,26,80,128
26119,prejano,"rioja,",32,50,48,100,210,440
26120,quel,"rioja,",612,302,448,1220,1666,4248
26121,rabanera,"rioja,",0,6,0,16,40,62
26122,rasillo,"rioja,",8,30,34,82,164,318
26123,"redal,","rioja,",36,6,26,80,148,296
26124,ribafrecha,"rioja,",364,142,154,660,806,2126
26125,rincon,"rioja,",1470,646,934,2386,2634,8070
26126,robres,"rioja,",2,0,2,4,40,48
26127,rodezno,"rioja,",44,8,22,144,238,456
26128,sajazarra,"rioja,",30,16,16,84,104,250
26129,san,"rioja,",286,124,172,536,1096,2214
26130,san,"rioja,",24,22,32,88,262,428
26131,san,"rioja,",0,0,4,12,48,64
26132,san,"rioja,",6,6,24,66,158,260
26134,santa,"rioja,",0,18,18,54,118,208
26135,santa,"rioja,",30,10,42,84,218,384
26136,santa,"rioja,",32,12,22,74,86,226
26138,santo,"rioja,",2200,942,1224,3518,4806,12690
26139,san,"rioja,",14,2,6,36,72,130
26140,santurde,"rioja,",42,36,40,118,286,522
26141,santurdejo,"rioja,",10,8,16,50,118,202
26142,san,"rioja,",234,140,212,538,908,2032
26143,sojuela,"rioja,",158,92,196,486,390,1322
26144,sorzano,"rioja,",30,20,26,146,216,438
26145,sotes,"rioja,",36,44,46,148,250,524
26146,soto,"rioja,",2,6,12,36,116,172
26147,terroba,"rioja,",8,0,4,22,44,78
26148,tirgo,"rioja,",32,24,26,78,188,348
26149,tobia,"rioja,",10,2,4,28,46,90
26150,tormantos,"rioja,",18,18,12,60,136,244
26151,torrecilla,"rioja,",66,44,104,222,492,928
26152,torrecilla,"rioja,",26,12,10,30,32,110
26153,torre,"rioja,",0,0,0,6,10,16
26154,torremontalbo,"rioja,",0,0,2,4,8,14
26155,treviana,"rioja,",4,12,26,48,202,292
26157,tricio,"rioja,",94,54,62,194,334,738
26158,tudelilla,"rioja,",116,50,60,212,306,744
26160,urunuela,"rioja,",356,152,174,580,716,1978
26161,valdemadera,"rioja,",0,2,0,6,16,24
26162,valganon,"rioja,",18,10,28,56,152,264
26163,ventosa,"rioja,",66,34,24,126,130,380
26164,ventrosa,"rioja,",8,0,8,30,58,104
26165,viguera,"rioja,",84,48,74,222,336,764
26166,villalba,"rioja,",36,14,30,72,172,324
26167,villalobar,"rioja,",14,2,8,38,84,146
26168,villamediana,"rioja,",4118,1314,1924,7094,3904,18354
26169,villanueva,"rioja,",14,8,8,30,82,142
26170,villar,"rioja,",216,82,126,320,484,1228
26171,villar,"rioja,",10,0,20,66,196,292
26172,villarejo,"rioja,",0,2,6,12,34,54
26173,villarroya,"rioja,",0,0,0,4,4,8
26174,villarta-quintana,"rioja,",14,10,22,48,166,260
26175,villavelayo,"rioja,",2,0,0,22,58,82
26176,villaverde,"rioja,",2,4,4,34,106,150
26177,villoslada,"rioja,",44,46,80,138,388,696
26178,viniegra,"rioja,",4,4,18,44,82,152
26179,viniegra,"rioja,",0,2,0,24,54,80
26180,zarraton,"rioja,",50,32,30,158,242,512
26181,zarzosa,"rioja,",0,0,2,10,16,28
26183,zorraquin,"rioja,",32,6,8,62,64,172
27001,abadin,lugo,304,148,310,1152,2520,4434
27002,alfoz,lugo,190,132,250,716,1758,3046
27003,antas,lugo,306,168,262,928,1986,3650
27004,baleira,lugo,166,62,166,522,1332,2248
27005,barreiros,lugo,630,240,466,1732,2982,6050
27006,becerrea,lugo,542,212,398,1442,2794,5388
27007,begonte,lugo,498,246,426,1418,3244,5832
27008,boveda,lugo,210,84,192,718,1618,2822
27009,carballedo,lugo,228,142,256,936,2522,4084
27010,castro,lugo,1070,412,884,2862,4840,10068
27011,castroverde,lugo,444,202,400,1240,2704,4990
27012,cervantes,lugo,76,90,164,504,1538,2372
27013,cervo,lugo,914,374,662,2438,3976,8364
27014,"corgo,",lugo,588,236,492,1734,3708,6758
27015,cospeito,lugo,778,326,666,2202,4474,8446
27016,chantada,lugo,1988,946,1478,4244,7500,16156
27017,folgoso,lugo,104,54,138,496,1166,1958
27018,"fonsagrada,",lugo,338,212,476,1360,3890,6276
27019,foz,lugo,2750,1138,1680,6250,8734,20552
27020,friol,lugo,650,250,646,1778,3876,7200
27021,xermade,lugo,282,100,278,790,1942,3392
27022,guitiriz,lugo,1140,482,752,2766,5122,10262
27023,guntin,lugo,348,196,368,1238,2922,5072
27024,"incio,",lugo,204,96,206,588,1930,3024
27025,xove,lugo,758,328,608,2140,2762,6596
27026,lancara,lugo,540,214,430,1268,2550,5002
27027,lourenza,lugo,534,210,302,1134,2006,4186
27028,lugo,lugo,30078,12788,19830,60100,75934,198730
27029,meira,lugo,472,168,328,984,1556,3508
27030,mondonedo,lugo,692,318,448,1708,3540,6706
27031,monforte,lugo,4820,2312,3582,9938,16492,37144
27032,monterroso,lugo,754,390,722,1944,3440,7250
27033,muras,lugo,80,48,76,306,688,1198
27034,navia,lugo,72,48,138,372,1326,1956
27035,negueira,lugo,50,16,46,146,222,480
27037,"nogais,",lugo,98,102,114,424,1144,1882
27038,ourol,lugo,168,66,164,488,1084,1970
27039,outeiro,lugo,1482,494,840,3256,4662,10734
27040,palas,lugo,628,312,538,1622,3488,6588
27041,panton,lugo,340,164,326,1080,2782,4692
27042,paradela,lugo,200,88,228,716,1940,3172
27043,"paramo,",lugo,214,148,196,624,1414,2596
27044,"pastoriza,",lugo,530,244,446,1450,2922,5592
27045,pedrafita,lugo,70,32,142,380,1176,1800
27046,pol,lugo,246,138,244,778,1678,3084
27047,pobra,lugo,222,128,238,700,1968,3256
27048,"pontenova,",lugo,374,182,344,912,2424,4236
27049,portomarin,lugo,186,118,216,580,1520,2620
27050,quiroga,lugo,600,250,410,1470,3380,6110
27051,ribadeo,lugo,2816,1232,1560,5938,8396,19942
27052,ribas,lugo,142,42,100,436,1096,1816
27053,ribeira,lugo,40,24,78,220,620,982
27054,riotorto,lugo,158,98,186,576,1336,2354
27055,samos,lugo,128,86,178,590,1420,2402
27056,rabade,lugo,404,168,352,860,1204,2988
27057,sarria,lugo,3614,1494,2562,7850,11548,27068
27058,"savinao,",lugo,554,266,462,1560,4122,6964
27059,sober,lugo,340,156,284,1006,2480,4266
27060,taboada,lugo,386,220,396,1190,3010,5202
27061,trabada,lugo,166,100,130,534,1240,2170
27062,triacastela,lugo,110,58,118,294,638,1218
27063,"valadouro,",lugo,474,146,262,1064,1890,3836
27064,"vicedo,",lugo,276,168,218,808,1710,3180
27065,vilalba,lugo,3366,1488,2392,7530,12868,27644
27066,viveiro,lugo,3872,1882,2678,9180,12866,30478
27901,baralla,lugo,398,196,414,1228,2708,4944
27902,burela,lugo,2900,1246,1682,6236,7046,19110
28001,"acebeda,",madrid,6,0,14,22,94,136
28002,ajalvir,madrid,1700,782,1286,3702,2422,9892
28003,alameda,madrid,78,34,42,138,220,512
28004,"alamo,",madrid,4072,1746,2172,6468,6368,20826
28005,alcala,madrid,65974,31834,45278,123682,132840,399608
28006,alcobendas,madrid,45692,19890,28406,75886,73018,242892
28007,alcorcon,madrid,56412,27144,34026,109802,122096,349480
28008,aldea,madrid,1290,450,666,2238,2200,6844
28009,algete,madrid,8326,4278,4438,12510,12716,42268
28010,alpedrete,madrid,5830,3010,3116,9892,9462,31310
28011,ambite,madrid,212,78,112,456,544,1402
28012,anchuelo,madrid,602,188,296,946,754,2786
28013,aranjuez,madrid,23862,10246,13692,38498,38718,125016
28014,arganda,madrid,23992,8830,13546,40842,31208,118418
28015,arroyomolinos,madrid,20724,5446,5894,30476,12058,74598
28016,"atazar,",madrid,26,16,20,58,94,214
28017,batres,madrid,658,330,372,1328,1226,3914
28018,becerril,madrid,2392,1092,1256,4148,4218,13106
28019,belmonte,madrid,700,266,456,1236,1180,3838
28020,berzosa,madrid,74,28,38,106,222,468
28021,"berrueco,",madrid,262,90,140,508,656,1656
28022,boadilla,madrid,31750,13430,10292,43250,32334,131056
28023,"boalo,",madrid,3664,1358,1330,6124,4620,17096
28024,braojos,madrid,44,34,56,130,174,438
28025,brea,madrid,114,100,124,290,506,1134
28026,brunete,madrid,4338,2110,2498,7298,6282,22526
28027,buitrago,madrid,724,286,412,1202,1316,3940
28028,bustarviejo,madrid,1026,360,486,2068,1726,5666
28029,cabanillas,madrid,334,158,140,662,604,1898
28030,"cabrera,",madrid,1046,452,552,1996,1858,5904
28031,cadalso,madrid,1076,470,654,1936,2412,6548
28032,camarma,madrid,3320,1374,1688,5850,3982,16214
28033,campo,madrid,2734,874,1496,4806,3622,13532
28034,canencia,madrid,96,68,88,212,472,936
28035,carabana,madrid,886,318,434,1690,1422,4750
28036,casarrubuelos,madrid,1810,678,844,3120,1998,8450
28037,cenicientos,madrid,618,290,426,1102,1846,4282
28038,cercedilla,madrid,2396,1198,1734,4648,5316,15292
28039,cervera,madrid,28,16,30,84,164,322
28040,ciempozuelos,madrid,9490,4064,5876,17042,15620,52092
28041,cobena,madrid,3560,1402,1434,5296,3792,15484
28042,colmenar,madrid,688,240,380,1290,1428,4026
28043,colmenar,madrid,2996,1396,1926,5690,5956,17964
28044,colmenarejo,madrid,3690,2082,1968,6152,5590,19482
28045,colmenar,madrid,22798,9054,13256,37126,31522,113756
28046,collado,madrid,2758,1340,1452,4736,4842,15128
28047,collado,madrid,23020,11248,17180,41930,41268,134646
28048,corpa,madrid,312,94,136,574,474,1590
28049,coslada,madrid,24046,10620,17520,48606,60584,161376
28050,cubas,madrid,3434,1176,1080,5172,3106,13968
28051,chapineria,madrid,1158,344,500,1650,1616,5268
28052,chinchon,madrid,1934,830,1218,3558,4100,11640
28053,daganzo,madrid,4844,2248,1686,7600,4968,21346
28054,"escorial,",madrid,5624,2774,3466,10026,12634,34524
28055,estremera,madrid,450,190,268,856,1138,2902
28056,fresnedillas,madrid,762,292,376,1186,1050,3666
28057,fresno,madrid,1100,374,456,1834,1330,5094
28058,fuenlabrada,madrid,64128,32008,41434,118436,124986,380992
28059,fuente,madrid,2698,1338,1660,4764,4308,14768
28060,fuentiduena,madrid,770,308,520,1394,1646,4638
28061,galapagar,madrid,13306,6410,8554,21520,22434,72224
28062,garganta,madrid,74,52,96,264,344,830
28063,gargantilla,madrid,110,26,60,248,358,802
28064,gascones,madrid,90,22,54,146,160,472
28065,getafe,madrid,69468,27948,40756,125654,119294,383120
28066,grinon,madrid,4148,1872,2062,6772,6574,21428
28067,guadalix,madrid,2550,1184,1360,4616,4114,13824
28068,guadarrama,madrid,6112,2844,3154,10482,11546,34138
28069,"hiruela,",madrid,16,6,8,44,94,168
28070,horcajo,madrid,66,16,52,164,164,462
28071,horcajuelo,madrid,28,24,22,52,96,222
28072,hoyo,madrid,3242,1586,2208,5256,6080,18372
28073,humanes,madrid,9190,3094,4360,14524,8940,40108
28074,leganes,madrid,63678,28354,41202,119052,135582,387868
28075,loeches,madrid,3996,1498,1906,6972,4134,18506
28076,lozoya,madrid,124,66,128,338,584,1240
28078,madarcos,madrid,14,8,18,40,60,140
28079,madrid,madrid,1016430,514494,987430,2023530,2302948,6844832
28080,majadahonda,madrid,28692,13692,15240,42174,47296,147094
28082,manzanares,madrid,3726,1380,1568,7032,5372,19078
28083,meco,madrid,6578,2674,3814,10932,7626,31624
28084,mejorada,madrid,9208,3994,5496,16536,14030,49264
28085,miraflores,madrid,2546,1138,1444,4824,4466,14418
28086,"molar,",madrid,3930,1616,2398,7158,5056,20158
28087,"molinos,",madrid,1398,766,1056,2638,3766,9624
28088,montejo,madrid,70,72,68,196,342,748
28089,moraleja,madrid,2270,892,1238,3722,3138,11260
28090,moralzarzal,madrid,5796,2664,2414,9576,8558,29008
28091,morata,madrid,2930,1206,1838,5306,5308,16588
28092,mostoles,madrid,69918,29140,46190,132370,148918,426536
28093,navacerrada,madrid,1096,492,616,2090,2320,6614
28094,navalafuente,madrid,696,248,340,1156,966,3406
28095,navalagamella,madrid,1232,504,720,2054,1728,6238
28096,navalcarnero,madrid,14966,4706,6608,23096,15992,65368
28097,navarredonda,madrid,22,12,26,72,176,308
28099,navas,madrid,1196,520,740,2096,2136,6688
28100,nuevo,madrid,2572,1222,1484,4788,4720,14786
28101,olmeda,madrid,152,52,68,274,272,818
28102,orusco,madrid,504,250,292,950,1012,3008
28104,paracuellos,madrid,14758,4188,3628,21492,10416,54482
28106,parla,madrid,58602,20990,30484,94452,65224,269752
28107,patones,madrid,172,66,78,342,550,1208
28108,pedrezuela,madrid,2838,822,1318,4804,3168,12950
28109,pelayos,madrid,1080,478,676,1884,2094,6212
28110,perales,madrid,1168,474,672,2134,1942,6390
28111,pezuela,madrid,370,134,174,642,660,1980
28112,pinilla,madrid,42,22,32,108,194,398
28113,pinto,madrid,22622,8744,12226,39356,29030,111978
28114,pinuecar-gandullas,madrid,58,16,32,106,158,370
28115,pozuelo,madrid,34362,17660,18658,47300,60266,178246
28116,pozuelo,madrid,592,156,302,974,580,2604
28117,pradena,madrid,42,6,30,96,104,278
28118,puebla,madrid,8,8,28,60,82,186
28119,quijorna,madrid,1686,772,758,2694,2064,7974
28120,rascafria,madrid,368,212,360,848,1636,3424
28121,reduena,madrid,76,68,54,208,178,584
28122,ribatejada,madrid,290,120,176,640,596,1822
28123,rivas-vaciamadrid,madrid,45520,16522,22308,69148,49776,203274
28124,robledillo,madrid,38,28,28,80,90,264
28125,robledo,madrid,1508,706,830,2962,3520,9526
28126,robregordo,madrid,16,4,16,52,58,146
28127,rozas,madrid,41104,18696,19548,60994,58044,198386
28128,rozas,madrid,112,86,108,332,524,1162
28129,san,madrid,5988,2586,2682,9170,7272,27698
28130,san,madrid,12038,6544,8942,23630,26784,77938
28131,san,madrid,6376,3108,3924,10618,13518,37544
28132,san,madrid,8750,3356,4966,13916,10340,41328
28133,san,madrid,3348,1378,1874,5386,6254,18240
28134,san,madrid,37070,14794,21028,63340,53652,189884
28135,santa,madrid,454,178,240,944,1216,3032
28136,santorcaz,madrid,328,162,196,660,650,1996
28137,santos,madrid,1242,400,548,2140,1264,5594
28138,serna,madrid,34,16,26,60,74,210
28140,serranillos,madrid,1890,878,802,3180,2514,9264
28141,sevilla,madrid,4074,1692,1680,6870,5072,19388
28143,somosierra,madrid,18,18,28,58,74,196
28144,soto,madrid,3196,1850,1858,5382,6586,18872
28145,talamanca,madrid,1888,628,958,3174,2404,9052
28146,tielmes,madrid,1014,384,642,1820,1754,5614
28147,titulcia,madrid,490,206,306,884,900,2786
28148,torrejon,madrid,52102,21064,32324,97212,79392,282094
28149,torrejon,madrid,4794,1608,2252,7246,4832,20732
28150,torrejon,madrid,1982,802,986,3320,2684,9774
28151,torrelaguna,madrid,1816,744,980,3246,3198,9984
28152,torrelodones,madrid,10590,5232,4946,14396,15336,50500
28153,torremocha,madrid,406,142,142,644,934,2268
28154,torres,madrid,2910,1398,1494,5132,4550,15484
28155,valdaracete,madrid,186,92,162,350,516,1306
28156,valdeavero,madrid,742,244,400,1288,960,3634
28157,valdelaguna,madrid,376,156,238,720,668,2158
28158,valdemanco,madrid,372,126,184,736,712,2130
28159,valdemaqueda,madrid,262,104,144,470,692,1672
28160,valdemorillo,madrid,5432,2430,2688,9282,8446,28278
28161,valdemoro,madrid,35742,14842,17534,60444,38602,167164
28162,valdeolmos-alalpardo,madrid,2128,710,888,3250,2182,9158
28163,valdepielagos,madrid,180,92,132,450,392,1246
28164,valdetorres,madrid,1736,830,1080,3350,3104,10100
28165,valdilecha,madrid,1270,478,752,2064,1892,6456
28166,valverde,madrid,178,84,110,370,368,1110
28167,velilla,madrid,5426,2528,3548,9656,6858,28016
28168,"vellon,",madrid,756,294,440,1568,1262,4320
28169,venturada,madrid,926,488,434,1736,1570,5154
28170,villaconejos,madrid,1244,544,786,2076,2324,6974
28171,villa,madrid,2792,1236,1802,4364,4654,14848
28172,villalbilla,madrid,8504,2514,3838,13492,7586,35934
28173,villamanrique,madrid,234,112,178,512,604,1640
28174,villamanta,madrid,1018,396,636,1742,1918,5710
28175,villamantilla,madrid,720,234,300,1192,794,3240
28176,villanueva,madrid,10146,5362,5344,13862,12714,47428
28177,villanueva,madrid,8264,3762,3388,12306,8268,35988
28178,villanueva,madrid,640,308,304,1206,978,3436
28179,villar,madrid,814,352,456,1434,1492,4548
28180,villarejo,madrid,2968,1252,1806,4794,4954,15774
28181,villaviciosa,madrid,9448,7278,6040,15674,20148,58588
28182,villavieja,madrid,98,54,74,194,234,654
28183,zarzalejo,madrid,726,254,308,1214,1238,3740
28901,lozoyuela-navas-sieteiglesias,madrid,510,196,282,996,974,2958
28902,puentes,madrid,266,102,122,496,562,1548
28903,tres,madrid,20804,8782,12074,31976,32014,105650
29001,alameda,malaga,1858,924,1200,3334,3562,10878
29002,alcaucin,malaga,694,294,452,1212,2730,5382
29003,alfarnate,malaga,244,118,228,524,976,2090
29004,alfarnatejo,malaga,62,28,70,180,402,742
29005,algarrobo,malaga,2314,1054,1490,4054,4884,13796
29006,algatocin,malaga,216,102,164,514,680,1676
29007,alhaurin,malaga,18682,7694,8656,29766,24346,89144
29008,alhaurin,malaga,11012,4348,6340,16612,16768,55080
29009,almachar,malaga,610,308,396,1094,1434,3842
29010,almargen,malaga,540,298,408,1124,1492,3862
29011,almogia,malaga,1246,620,962,2512,2944,8284
29012,alora,malaga,4318,2070,3090,7906,9664,27048
29013,alozaina,malaga,600,318,454,1156,1726,4254
29014,alpandeire,malaga,52,22,44,144,246,508
29015,antequera,malaga,14566,6900,9754,23808,28128,83156
29016,archez,malaga,74,66,72,190,430,832
29017,archidona,malaga,2498,1272,1740,4376,6154,16040
29018,ardales,malaga,818,392,588,1424,1802,5024
29019,arenas,malaga,354,188,222,726,1100,2590
29020,arriate,malaga,1356,662,850,2538,2762,8168
29021,atajate,malaga,54,22,44,116,156,392
29022,benadalid,malaga,52,38,48,90,236,464
29023,benahavis,malaga,4046,1176,1936,6420,4934,18512
29024,benalauria,malaga,116,64,88,322,338,928
29025,benalmadena,malaga,27708,10790,16638,53530,47356,156022
29026,benamargosa,malaga,432,180,330,826,1324,3092
29027,benamocarra,malaga,1242,432,638,1956,1948,6216
29028,benaojan,malaga,420,186,312,826,1122,2866
29029,benarraba,malaga,110,46,104,254,418,932
29030,"borge,",malaga,256,112,196,574,742,1880
29031,"burgo,",malaga,456,200,370,894,1592,3512
29032,campillos,malaga,2900,1308,2060,4818,5896,16982
29033,canillas,malaga,384,234,330,948,1626,3522
29034,canillas,malaga,184,92,132,388,830,1626
29035,canete,malaga,294,214,324,800,1548,3180
29036,carratraca,malaga,196,90,172,410,696,1564
29037,cartajima,malaga,24,38,52,116,228,458
29038,cartama,malaga,13002,4390,6368,20434,13504,57698
29039,casabermeja,malaga,1360,610,866,2614,2698,8148
29040,casarabonela,malaga,862,366,636,1578,2120,5562
29041,casares,malaga,3198,1060,1980,5578,5240,17056
29042,coin,malaga,10822,4096,5916,15740,14952,51526
29043,colmenar,malaga,1176,518,808,2070,2518,7090
29044,comares,malaga,230,134,220,646,1450,2680
29045,competa,malaga,1024,350,704,1684,3484,7246
29046,cortes,malaga,876,466,634,1622,2466,6064
29047,cuevas,malaga,492,198,264,756,972,2682
29048,cuevas,malaga,442,154,376,834,1396,3202
29049,cuevas,malaga,1190,522,842,1834,2866,7254
29050,cutar,malaga,114,54,92,290,628,1178
29051,estepona,malaga,29328,11588,17028,51922,47314,157180
29052,farajan,malaga,64,42,46,136,280,568
29053,frigiliana,malaga,1118,430,572,1996,2668,6784
29054,fuengirola,malaga,25568,11582,18084,51116,64942,171292
29055,fuente,malaga,1050,418,636,1766,2076,5946
29056,gaucin,malaga,500,202,278,900,1304,3184
29057,genalguacil,malaga,88,32,64,212,412,808
29058,guaro,malaga,886,354,540,1550,1642,4972
29059,humilladero,malaga,1150,552,832,1960,2238,6732
29060,igualeja,malaga,208,110,142,432,662,1554
29061,istan,malaga,496,228,338,1082,1130,3274
29062,iznate,malaga,356,128,202,558,658,1902
29063,jimera,malaga,82,34,62,198,422,798
29064,jubrique,malaga,132,72,124,346,498,1172
29065,juzcar,malaga,24,34,54,134,210,456
29066,macharaviaya,malaga,148,74,132,294,368,1016
29067,malaga,malaga,201180,93568,141690,358662,389592,1184692
29068,manilva,malaga,6928,2344,3954,11922,10812,35960
29069,marbella,malaga,56288,25572,37622,101456,97170,318108
29070,mijas,malaga,36516,13330,20096,62184,52296,184422
29071,moclinejo,malaga,408,192,332,770,776,2478
29072,mollina,malaga,1702,802,960,2890,4580,10934
29073,monda,malaga,1102,508,754,1790,1876,6030
29074,montejaque,malaga,230,126,178,466,904,1904
29075,nerja,malaga,6450,2894,4232,12430,18150,44156
29076,ojen,malaga,1762,618,1096,3324,2642,9442
29077,parauta,malaga,102,24,46,180,214,566
29079,periana,malaga,1020,476,770,1912,2600,6778
29080,pizarra,malaga,3934,1638,2134,6632,6036,20374
29081,pujerra,malaga,58,26,36,170,292,582
29082,rincon,malaga,20992,8138,9710,35458,29788,104086
29083,riogordo,malaga,740,430,584,1604,2232,5590
29084,ronda,malaga,10718,5114,7294,19616,24298,67040
29085,salares,malaga,64,26,42,94,182,408
29086,sayalonga,malaga,362,194,308,736,1648,3248
29087,sedella,malaga,76,56,90,314,676,1212
29088,sierra,malaga,1228,520,710,2050,2406,6914
29089,teba,malaga,1064,592,824,2092,2834,7406
29090,tolox,malaga,820,304,496,1344,1824,4788
29091,torrox,malaga,6094,2518,4192,11666,18342,42812
29092,totalan,malaga,260,110,156,492,538,1556
29093,valle,malaga,638,320,532,1344,2088,4922
29094,velez-malaga,malaga,32048,12942,18588,55272,55750,174600
29095,villanueva,malaga,1282,544,904,2192,3210,8132
29096,villanueva,malaga,1042,436,712,1912,2694,6796
29097,villanueva,malaga,1778,854,1250,3192,3798,10872
29098,villanueva,malaga,348,178,292,752,1216,2786
29099,vinuela,malaga,470,226,318,928,2036,3978
29100,yunquera,malaga,792,460,664,1446,2392,5754
29901,torremolinos,malaga,23706,9482,15082,47140,46430,141840
29902,villanueva,malaga,1052,566,742,1886,2308,6554
29903,montecorto,malaga,146,94,134,324,500,1198
29904,serrato,malaga,96,68,100,228,424,916
30001,abanilla,murcia,1804,802,1156,3260,5412,12434
30002,abaran,murcia,4682,2004,3060,8194,8148,26088
30003,aguilas,murcia,13748,5980,8570,22794,23524,74616
30004,albudeite,murcia,470,214,348,824,946,2802
30005,alcantarilla,murcia,17094,7502,10488,27312,24672,87068
30006,aledo,murcia,296,178,202,608,952,2236
30007,alguazas,murcia,4536,1674,2352,6500,5260,20322
30008,alhama,murcia,9448,3792,5244,14872,13946,47302
30009,archena,murcia,7738,3708,5632,13324,11326,41728
30010,beniel,murcia,4926,1910,2814,7222,6026,22898
30011,blanca,murcia,2458,1078,1618,4242,4210,13606
30012,bullas,murcia,3886,1940,2888,6544,8268,23526
30013,calasparra,murcia,3472,1480,2388,5872,7262,20474
30014,campos,murcia,752,300,520,1198,1548,4318
30015,caravaca,murcia,9164,4312,6076,15040,17496,52088
30016,cartagena,murcia,84824,36270,47770,128766,140840,438470
30017,cehegin,murcia,4560,2238,3186,8362,10972,29318
30018,ceuti,murcia,5424,2130,3274,8706,6294,25828
30019,cieza,murcia,13392,5944,8288,20688,22142,70454
30020,fortuna,murcia,4530,1850,2684,7000,6568,22632
30021,fuente,murcia,7736,3440,5040,11334,9856,37406
30022,jumilla,murcia,10328,4814,7108,16964,14954,54168
30023,librilla,murcia,2356,848,1330,3694,3364,11592
30024,lorca,murcia,39994,17022,24326,59824,54372,195538
30025,lorqui,murcia,3112,1268,2006,4912,4266,15564
30026,mazarron,murcia,12378,5366,7944,20226,24832,70746
30027,molina,murcia,32176,12834,17228,49894,41892,154024
30028,moratalla,murcia,2150,1018,1480,4232,6260,15140
30029,mula,murcia,6706,3112,4298,10694,10490,35300
30030,murcia,murcia,178260,79074,114924,286040,285666,943964
30031,ojos,murcia,98,62,128,286,502,1076
30032,pliego,murcia,1446,664,902,2316,2710,8038
30033,puerto,murcia,7212,2934,4862,11694,9216,35918
30034,ricote,murcia,248,190,246,644,1112,2440
30035,san,murcia,15020,5660,8048,21876,20832,71436
30036,san,murcia,12444,4604,6952,17304,16366,57670
30037,torre-pacheco,murcia,18678,7300,9368,25114,19360,79820
30038,torres,murcia,9058,3800,4994,14418,12784,45054
30039,totana,murcia,13412,6620,8356,22472,17884,68744
30040,ulea,murcia,278,126,182,538,658,1782
30041,"union,",murcia,9644,3584,4812,13174,10966,42180
30042,villanueva,murcia,1602,628,1150,2708,1832,7920
30043,yecla,murcia,13826,6400,8354,21036,22204,71820
30901,santomera,murcia,6972,2750,3568,10590,8752,32632
30902,"alcazares,",murcia,7988,2946,4568,11926,11376,38804
31001,abaigar,navarra,24,2,16,54,78,174
31002,abarzuza/abartzuza,navarra,156,104,98,234,442,1034
31003,abaurregaina/abaurrea,navarra,26,6,14,68,130,244
31004,abaurrepea/abaurrea,navarra,0,0,8,16,34,58
31005,aberin,navarra,106,50,84,244,282,766
31006,ablitas,navarra,854,410,552,1508,1994,5318
31007,adios,navarra,40,38,30,114,160,382
31008,aguilar,navarra,20,2,6,32,90,150
31009,aibar/oibar,navarra,188,106,166,356,712,1528
31010,altsasu/alsasua,navarra,2666,1136,1614,4302,5656,15374
31011,allin/allin,navarra,272,106,162,504,760,1804
31012,allo,navarra,288,130,180,522,880,2000
31013,amescoa,navarra,154,100,132,324,746,1456
31014,ancin/antzin,navarra,90,70,62,200,276,698
31015,andosilla,navarra,1074,536,676,1498,2050,5834
31016,ansoain/antsoain,navarra,3560,2314,1918,6844,6596,21232
31017,anue,navarra,180,76,72,292,348,968
31018,anorbe,navarra,244,118,124,414,374,1274
31019,aoiz/agoitz,navarra,1244,478,630,1872,1764,5988
31020,araitz,navarra,146,72,74,284,470,1046
31021,aranarache/aranaratxe,navarra,16,0,14,48,62,140
31022,arantza,navarra,246,80,96,346,472,1240
31023,aranguren,navarra,6494,2060,2850,8516,5644,25564
31024,arano,navarra,38,10,6,76,90,220
31025,arakil,navarra,310,140,206,570,774,2000
31026,aras,navarra,36,16,24,54,180,310
31027,arbizu,navarra,462,170,202,664,726,2224
31028,arce/artzi,navarra,74,44,58,196,230,602
31029,"arcos,",navarra,334,156,278,516,1084,2368
31030,arellano,navarra,26,20,24,72,174,316
31031,areso,navarra,102,36,54,136,206,534
31032,arguedas,navarra,796,302,484,1320,1690,4592
31033,aria,navarra,18,0,6,36,42,102
31034,aribe,navarra,2,2,0,18,42,64
31035,armananzas,navarra,12,0,2,20,72,106
31036,arroniz,navarra,280,148,248,498,962,2136
31037,arruazu,navarra,34,26,22,72,88,242
31038,artajona,navarra,568,240,362,938,1436,3544
31039,artazu,navarra,42,12,22,62,108,246
31040,atetz,navarra,58,32,24,116,204,434
31041,ayegui/aiegi,navarra,1184,388,460,1672,1390,5094
31042,azagra,navarra,1432,518,874,2120,2550,7494
31043,azuelo,navarra,0,4,0,18,44,66
31044,bakaiku,navarra,106,34,60,164,316,680
31045,barasoain,navarra,180,86,132,340,452,1190
31046,barbarin,navarra,0,2,10,18,62,92
31047,bargota,navarra,30,32,32,102,298,494
31048,barillas,navarra,82,30,54,104,202,472
31049,basaburua,navarra,222,112,136,478,716,1664
31050,baztan,navarra,2708,1212,1494,4370,5916,15700
31051,beire,navarra,94,22,28,164,270,578
31052,belascoain,navarra,16,26,28,58,132,260
31053,berbinzana,navarra,228,80,140,324,576,1348
31054,bertizarana,navarra,266,78,122,380,480,1326
31055,betelu,navarra,142,80,62,214,272,770
31056,biurrun-olcoz,navarra,80,28,30,170,164,472
31057,bunuel,navarra,708,286,486,1238,1906,4624
31058,auritz/burguete,navarra,54,30,40,124,212,460
31059,burgui/burgi,navarra,44,24,26,82,208,384
31060,burlada/burlata,navarra,7322,3440,5112,12546,13680,42100
31061,"busto,",navarra,12,0,4,16,80,112
31062,cabanillas,navarra,388,218,306,732,1104,2748
31063,cabredo,navarra,12,2,10,28,96,148
31064,cadreita,navarra,814,286,504,1306,1476,4386
31065,caparroso,navarra,1036,486,680,1640,1906,5748
31066,carcar,navarra,402,162,282,540,888,2274
31067,carcastillo,navarra,738,312,580,1210,1978,4818
31068,cascante,navarra,1592,548,836,2322,2938,8236
31069,caseda,navarra,226,110,232,442,856,1866
31070,castejon,navarra,1980,724,928,2678,2644,8954
31071,castillonuevo,navarra,0,0,0,4,26,30
31072,cintruenigo,navarra,3564,1278,1718,5046,5016,16622
31073,ziordia,navarra,90,48,78,218,284,718
31074,cirauqui/zirauki,navarra,160,52,108,236,374,930
31075,ciriza/ziritza,navarra,54,32,52,86,96,320
31076,cizur,navarra,2040,1092,754,2140,1862,7888
31077,corella,navarra,3528,1432,2038,4846,5440,17284
31078,cortes,navarra,1034,372,664,1708,2528,6306
31079,desojo,navarra,8,4,12,20,90,134
31080,dicastillo,navarra,160,72,98,298,514,1142
31081,donamaria,navarra,176,76,72,232,354,910
31082,etxalar,navarra,296,114,136,480,602,1628
31083,echarri/etxarri,navarra,34,24,10,54,42,164
31084,etxarri,navarra,1010,322,460,1402,1884,5078
31085,etxauri,navarra,276,76,118,378,490,1338
31086,valle,navarra,12966,3316,3664,17798,7132,44876
31087,elgorriaga,navarra,70,24,46,112,172,424
31088,noain,navarra,3978,1152,1612,5956,4208,16906
31089,eneriz/eneritz,navarra,90,64,70,206,218,648
31090,eratsun,navarra,26,8,30,86,160,310
31091,ergoiena,navarra,84,30,72,186,394,766
31092,erro,navarra,232,80,170,468,678,1628
31093,ezcaroz/ezkaroze,navarra,70,18,46,162,312,608
31094,eslava,navarra,24,10,8,44,126,212
31095,esparza,navarra,8,6,4,38,98,154
31096,espronceda,navarra,18,8,6,62,122,216
31097,estella-lizarra,navarra,4494,2262,3214,7698,11086,28754
31098,esteribar,navarra,1222,470,480,1934,1650,5756
31099,etayo,navarra,4,6,20,34,78,142
31100,eulate,navarra,54,30,38,130,290,542
31101,ezcabarte,navarra,614,316,376,1206,1232,3744
31102,ezkurra,navarra,12,10,14,70,166,272
31103,ezprogui,navarra,12,2,10,26,52,102
31104,falces,navarra,728,310,476,1190,1998,4702
31105,fitero,navarra,928,280,378,1156,1684,4426
31106,fontellas,navarra,382,166,186,620,680,2034
31107,funes,navarra,956,374,536,1520,1790,5176
31108,fustinana,navarra,800,332,390,1384,1978,4884
31109,galar,navarra,1076,422,428,1526,1342,4794
31110,gallipienzo/galipentzu,navarra,10,18,2,50,116,196
31111,gallues/galoze,navarra,10,6,14,56,110,196
31112,garaioa,navarra,6,6,8,52,108,180
31113,garde,navarra,24,10,18,58,150,260
31114,garinoain,navarra,164,120,126,332,312,1054
31115,garralda,navarra,60,16,34,110,158,378
31116,genevilla,navarra,4,4,12,42,80,142
31117,goizueta,navarra,220,84,146,306,628,1384
31118,goni,navarra,18,24,38,84,180,344
31119,guesa/gorza,navarra,6,0,6,16,46,74
31120,guesalaz/gesalatz,navarra,88,36,74,230,436,864
31121,guirguillano,navarra,12,14,12,50,60,148
31122,huarte/uharte,navarra,3544,1214,1564,5136,3998,15456
31123,uharte,navarra,276,88,130,460,632,1586
31124,ibargoiti,navarra,76,34,50,154,224,538
31125,iguzquiza,navarra,66,52,66,150,272,606
31126,imotz,navarra,126,50,48,250,350,824
31127,iraneta,navarra,82,10,22,100,126,340
31128,isaba/izaba,navarra,64,58,72,188,386,768
31129,ituren,navarra,232,70,82,292,374,1050
31130,iturmendi,navarra,130,82,114,178,362,866
31131,iza/itza,navarra,490,234,236,908,886,2754
31132,izagaondoa,navarra,38,18,28,80,156,320
31133,izalzu/itzaltzu,navarra,10,2,6,20,38,76
31134,jaurrieta,navarra,26,18,16,82,218,360
31135,javier,navarra,16,10,8,36,150,220
31136,juslapena/txulapain,navarra,150,92,104,308,486,1140
31137,beintza-labaien,navarra,42,22,36,132,206,438
31138,lakuntza,navarra,550,238,220,792,844,2644
31139,lana,navarra,10,26,24,64,190,314
31140,lantz,navarra,66,28,8,98,104,304
31141,lapoblacion,navarra,32,8,26,70,120,256
31142,larraga,navarra,840,310,444,1214,1446,4254
31143,larraona,navarra,14,12,22,50,112,210
31144,larraun,navarra,282,116,154,476,788,1816
31145,lazagurria,navarra,26,24,36,94,172,352
31146,leache/leatxe,navarra,6,2,8,20,44,80
31147,legarda,navarra,50,14,22,88,118,292
31148,legaria,navarra,22,20,26,42,124,234
31149,leitza,navarra,1190,372,502,1734,2248,6046
31150,leoz/leotz,navarra,30,20,38,122,210,420
31151,lerga,navarra,2,4,2,14,68,90
31152,lerin,navarra,562,200,432,852,1496,3542
31153,lesaka,navarra,896,410,466,1522,2138,5432
31154,lezaun,navarra,62,36,80,116,202,496
31155,liedena,navarra,112,50,62,190,290,704
31156,lizoain-arriasgoiti/lizoainibar-arriasgoiti,navarra,94,40,42,198,202,576
31157,lodosa,navarra,1742,670,1216,2814,3376,9818
31158,longuida/longida,navarra,66,46,48,160,282,602
31159,lumbier,navarra,352,140,250,788,1130,2660
31160,luquin,navarra,34,24,28,68,110,264
31161,maneru,navarra,194,48,52,298,318,910
31162,maranon,navarra,0,4,2,28,66,100
31163,marcilla,navarra,1096,476,636,1632,1998,5838
31164,melida,navarra,202,114,120,390,636,1462
31165,mendavia,navarra,1084,456,694,1944,2862,7040
31166,mendaza,navarra,58,42,40,126,318,584
31167,mendigorria,navarra,482,162,222,762,822,2450
31168,metauten,navarra,54,32,32,150,256,524
31169,milagro,navarra,1438,496,908,2222,2192,7256
31170,mirafuentes,navarra,24,4,6,34,48,116
31171,miranda,navarra,284,120,176,488,732,1800
31172,monreal/elo,navarra,194,102,78,364,290,1028
31173,monteagudo,navarra,284,154,238,570,926,2172
31174,morentin,navarra,30,14,14,74,82,214
31175,mues,navarra,6,10,18,32,94,160
31176,murchante,navarra,1736,612,928,2546,2690,8512
31177,murieta,navarra,126,42,72,206,270,716
31178,murillo,navarra,242,86,162,420,504,1414
31179,murillo,navarra,190,134,184,320,528,1356
31180,muruzabal,navarra,54,46,50,152,248,550
31181,navascues/nabaskoze,navarra,0,6,14,64,152,236
31182,nazar,navarra,12,4,8,28,34,86
31183,obanos,navarra,270,142,184,520,686,1802
31184,oco,navarra,20,4,10,34,58,126
31185,ochagavia/otsagabia,navarra,58,62,80,226,554,980
31186,odieta,navarra,148,50,50,222,284,754
31187,oiz,navarra,30,22,30,74,114,270
31188,olaibar,navarra,104,68,80,266,300,818
31189,olazti/olazagutia,navarra,444,192,296,784,1204,2920
31190,olejua,navarra,10,0,4,32,48,94
31191,olite/erriberri,navarra,1352,576,896,2462,2908,8194
31192,oloriz/oloritz,navarra,82,30,38,136,144,430
31193,cendea,navarra,660,300,386,1044,1296,3686
31194,valle,navarra,150,82,98,260,316,906
31195,orbaizeta,navarra,46,18,42,84,188,378
31196,orbara,navarra,2,0,6,10,40,58
31197,orisoain,navarra,10,20,14,26,74,144
31198,oronz/orontze,navarra,12,10,16,30,34,102
31199,oroz-betelu/orotz-betelu,navarra,18,6,16,82,164,286
31200,oteiza,navarra,286,144,140,574,750,1894
31201,pamplona/iruna,navarra,64878,34572,48204,115714,153118,416486
31202,peralta/azkoien,navarra,2210,1022,1352,3484,3910,11978
31203,petilla,navarra,4,0,2,30,20,56
31204,piedramillera,navarra,6,4,12,34,34,90
31205,pitillas,navarra,140,48,98,282,482,1050
31206,puente,navarra,1056,474,590,1706,2020,5846
31207,pueyo/puiu,navarra,108,54,54,224,280,720
31208,ribaforada,navarra,1260,570,786,2124,2634,7374
31209,romanzado/erromantzatua,navarra,52,20,28,106,174,380
31210,roncal/erronkari,navarra,40,12,52,100,226,430
31211,orreaga/roncesvalles,navarra,4,0,4,6,26,40
31212,sada,navarra,24,6,18,60,160,268
31213,saldias,navarra,52,10,24,72,88,246
31214,salinas,navarra,40,16,16,56,96,224
31215,san,navarra,2410,928,1368,3854,4424,12984
31216,sanguesa/zangoza,navarra,1382,834,966,2610,3960,9752
31217,san,navarra,70,22,58,192,394,736
31219,sansol,navarra,10,6,18,38,110,182
31220,santacara,navarra,206,108,182,414,808,1718
31221,doneztebe/santesteban,navarra,738,296,438,1054,1182,3708
31222,sarries/sartze,navarra,14,2,8,14,82,120
31223,sartaguda,navarra,446,156,290,748,1032,2672
31224,sesma,navarra,466,200,256,556,1016,2494
31225,sorlada,navarra,12,8,6,24,36,86
31226,sunbilla,navarra,246,78,90,442,532,1388
31227,tafalla,navarra,3272,1764,2350,5922,8270,21578
31228,tiebas-muruarte,navarra,186,108,126,422,476,1318
31229,tirapu,navarra,10,2,2,34,54,102
31230,torralba,navarra,24,8,16,62,86,196
31231,torres,navarra,14,22,12,52,128,228
31232,tudela,navarra,14334,6070,8682,23220,24576,76882
31233,tulebras,navarra,46,16,24,90,136,312
31234,ucar,navarra,50,24,26,138,140,378
31235,ujue/uxue,navarra,42,20,28,72,190,352
31236,ultzama,navarra,484,262,346,820,1340,3252
31237,unciti,navarra,62,26,30,160,204,482
31238,unzue/untzue,navarra,42,20,16,120,128,326
31239,urdazubi/urdax,navarra,148,34,50,244,288,764
31240,urdiain,navarra,202,104,128,328,526,1288
31241,urraul,navarra,12,8,18,80,154,272
31242,urraul,navarra,58,40,66,166,314,644
31243,urroz-villa,navarra,150,42,80,268,266,806
31244,urroz,navarra,62,14,38,96,138,348
31245,urzainqui/urzainki,navarra,16,4,10,40,86,156
31246,uterga,navarra,44,24,44,88,142,342
31247,uztarroz/uztarroze,navarra,16,2,22,50,190,280
31248,luzaide/valcarlos,navarra,64,28,62,166,328,648
31249,valtierra,navarra,862,342,512,1256,1930,4902
31250,bera,navarra,1388,598,646,2302,2646,7580
31251,viana,navarra,1666,584,806,2694,3092,8842
31252,vidangoz/bidankoze,navarra,14,2,10,28,98,152
31253,bidaurreta,navarra,80,20,2,128,112,342
31254,villafranca,navarra,1236,504,754,1690,1946,6130
31255,villamayor,navarra,16,22,24,44,120,226
31256,hiriberri/villanueva,navarra,16,8,18,50,108,200
31257,villatuerta,navarra,472,192,248,736,904,2552
31258,villava/atarrabia,navarra,3146,1670,2116,5350,7684,19966
31259,igantzi,navarra,204,106,102,314,458,1184
31260,valle,navarra,466,196,280,752,1434,3128
31261,yesa,navarra,44,42,46,178,270,580
31262,zabalza/zabaltza,navarra,98,44,52,180,222,596
31263,zubieta,navarra,112,40,48,142,236,578
31264,zugarramurdi,navarra,74,40,28,170,158,470
31265,zuniga,navarra,8,14,12,40,90,164
31901,baranain/baranain,navarra,5020,3156,4970,9966,15966,39078
31902,berrioplano/berriobeiti,navarra,4194,1040,1228,5966,2770,15198
31903,berriozar,navarra,4688,1926,2246,7874,5546,22280
31904,irurtzun,navarra,892,322,528,1428,1474,4644
31905,beriain,navarra,1584,712,920,2638,2528,8382
31906,orkoien,navarra,1954,722,780,3008,1726,8190
31907,zizur,navarra,6082,3096,3972,9148,9854,32152
31908,lekunberri,navarra,760,292,306,1108,930,3396
32001,allariz,ourense,1926,680,1090,3992,5154,12842
32002,amoeiro,ourense,498,174,332,1402,2386,4792
32003,"arnoia,",ourense,154,94,116,494,1070,1928
32004,avion,ourense,234,144,250,640,2170,3438
32005,baltar,ourense,108,56,120,438,992,1714
32006,bande,ourense,152,100,176,650,1858,2936
32007,banos,ourense,168,140,204,698,1788,2998
32008,barbadas,ourense,3758,1558,2088,7342,7580,22326
32009,barco,ourense,3856,1802,2688,7884,10374,26604
32010,beade,ourense,64,28,50,186,400,728
32011,beariz,ourense,122,76,132,382,1186,1898
32012,"blancos,",ourense,98,46,112,322,856,1434
32013,boboras,ourense,378,120,294,920,2680,4392
32014,"bola,",ourense,134,80,134,486,1346,2180
32015,"bolo,",ourense,88,36,112,276,1062,1574
32016,calvos,ourense,42,34,90,230,900,1296
32017,carballeda,ourense,242,62,208,754,1478,2744
32018,carballeda,ourense,162,90,156,516,1464,2388
32019,"carballino,",ourense,3664,1802,2356,8146,12188,28156
32020,cartelle,ourense,314,170,338,1206,2972,5000
32021,castrelo,ourense,188,64,108,440,1102,1902
32022,castrelo,ourense,170,88,154,604,1552,2568
32023,castro,ourense,166,88,186,644,1410,2494
32024,celanova,ourense,1300,578,884,2920,5720,11402
32025,cenlle,ourense,188,78,166,580,1142,2154
32026,coles,ourense,620,274,464,1690,3302,6350
32027,cortegada,ourense,138,68,204,492,1140,2042
32028,cualedro,ourense,174,104,182,656,2048,3164
32029,chandrexa,ourense,32,32,62,162,674,962
32030,entrimo,ourense,122,106,168,494,1270,2160
32031,esgos,ourense,198,64,162,570,1208,2202
32032,xinzo,ourense,2730,1164,1668,5380,8302,19244
32033,gomesende,ourense,50,44,78,294,844,1310
32034,"gudina,",ourense,190,94,194,666,1234,2378
32035,"irixo,",ourense,164,80,148,576,1742,2710
32036,xunqueira,ourense,244,86,206,622,1546,2704
32037,xunqueira,ourense,108,32,118,310,774,1342
32038,larouco,ourense,62,32,80,192,512,878
32039,laza,ourense,154,64,184,484,1442,2328
32040,leiro,ourense,242,90,188,620,1826,2966
32041,lobeira,ourense,42,28,72,278,1010,1430
32042,lobios,ourense,216,150,252,888,2138,3644
32043,maceda,ourense,646,310,544,1496,2734,5730
32044,manzaneda,ourense,136,28,118,370,944,1596
32045,maside,ourense,682,298,406,1522,2576,5484
32046,melon,ourense,132,62,126,500,1394,2214
32047,"merca,",ourense,374,134,258,1050,2062,3878
32048,"mezquita,",ourense,124,64,162,454,1224,2028
32049,montederramo,ourense,44,40,100,292,870,1346
32050,monterrei,ourense,350,176,292,1084,2904,4806
32051,muinos,ourense,116,108,216,636,1742,2818
32052,nogueira,ourense,338,164,236,1020,2326,4084
32053,oimbra,ourense,294,132,274,842,1872,3414
32054,ourense,ourense,29092,13642,20888,58192,87636,209450
32055,paderne,ourense,272,96,188,700,1444,2700
32056,padrenda,ourense,182,118,232,680,1904,3116
32057,parada,ourense,48,22,86,208,682,1046
32058,pereiro,ourense,2104,698,1008,4238,5402,13450
32059,"peroxa,",ourense,254,92,222,864,2092,3524
32060,petin,ourense,150,82,136,434,918,1720
32061,pinor,ourense,184,88,156,598,1212,2238
32062,porqueira,ourense,106,50,126,386,1012,1680
32063,pobra,ourense,344,176,286,948,2186,3940
32064,pontedeva,ourense,46,48,82,206,534,916
32065,punxin,ourense,112,44,122,342,894,1514
32066,quintela,ourense,76,66,92,226,726,1186
32067,rairiz,ourense,132,62,156,548,1456,2354
32068,ramiras,ourense,204,102,222,690,1788,3006
32069,ribadavia,ourense,1192,578,800,2682,4636,9888
32070,san,ourense,48,30,82,184,694,1038
32071,rios,ourense,166,104,212,606,1726,2814
32072,"rua,",ourense,866,496,720,2250,4110,8442
32073,rubia,ourense,236,98,222,650,1574,2780
32074,san,ourense,162,60,140,478,1240,2080
32075,san,ourense,1816,590,972,3970,4112,11460
32076,san,ourense,234,142,240,964,2398,3978
32077,sandias,ourense,160,70,184,564,1248,2226
32078,sarreaus,ourense,110,70,116,422,1418,2136
32079,taboadela,ourense,278,100,292,774,1534,2978
32080,"teixeira,",ourense,32,36,36,162,390,656
32081,toen,ourense,514,228,282,1376,2276,4676
32082,trasmiras,ourense,180,80,150,550,1478,2438
32083,"veiga,",ourense,100,66,162,382,1058,1768
32084,verea,ourense,144,68,164,430,1098,1904
32085,verin,ourense,3592,1892,2494,7590,11966,27534
32086,viana,ourense,522,254,392,1244,3064,5476
32087,vilamarin,ourense,336,112,278,974,2016,3716
32088,vilamartin,ourense,258,156,336,806,2116,3672
32089,vilar,ourense,98,70,130,486,1608,2392
32090,vilar,ourense,160,48,104,426,854,1592
32091,vilardevos,ourense,146,104,230,612,2238,3330
32092,vilarino,ourense,62,40,88,216,614,1020
33001,allande,asturias,208,104,234,704,1812,3062
33002,aller,asturias,1840,996,1602,5184,10358,19980
33003,amieva,asturias,76,54,74,280,722,1206
33004,aviles,asturias,19020,9190,12798,42620,67698,151326
33005,belmonte,asturias,212,120,248,706,1504,2790
33006,bimenes,asturias,328,126,258,924,1658,3294
33007,boal,asturias,154,86,226,622,1672,2760
33008,cabrales,asturias,396,150,314,1038,1928,3826
33009,cabranes,asturias,250,78,142,704,1016,2190
33010,candamo,asturias,358,180,262,1106,1888,3794
33011,cangas,asturias,2508,1232,1776,6040,11322,22878
33012,cangas,asturias,1726,766,1100,3710,5472,12774
33013,caravia,asturias,94,22,100,258,510,984
33014,carreno,asturias,2618,1130,1478,6278,9006,20510
33015,caso,asturias,180,58,196,730,1682,2846
33016,castrillon,asturias,5958,2380,3118,13352,19424,44232
33017,castropol,asturias,694,322,476,1798,3208,6498
33018,coana,asturias,904,336,554,1920,2920,6634
33019,colunga,asturias,558,286,444,1676,3360,6324
33020,corvera,asturias,4424,1880,2412,9890,12654,31260
33021,cudillero,asturias,996,478,710,2580,5080,9844
33022,degana,asturias,132,94,112,428,792,1558
33023,"franco,",asturias,934,372,608,2044,3542,7500
33024,gijon,asturias,68722,32424,45056,161924,232312,540438
33025,gozon,asturias,2458,1026,1538,5912,9854,20788
33026,grado,asturias,2374,1084,1638,5518,8746,19360
33027,grandas,asturias,90,60,110,370,934,1564
33028,ibias,asturias,92,88,192,460,1370,2202
33029,illano,asturias,24,24,32,142,356,578
33030,illas,asturias,264,122,124,638,920,2068
33031,langreo,asturias,9242,4310,5902,22454,34622,76530
33032,laviana,asturias,3030,1422,1728,7182,11276,24638
33033,lena,asturias,2338,992,1482,5764,10008,20584
33034,valdes,asturias,2250,1052,1510,5648,11304,21764
33035,llanera,asturias,4172,1846,2278,8846,10730,27872
33036,llanes,asturias,3336,1616,2256,7902,12086,27196
33037,mieres,asturias,7614,3550,5494,20460,35118,72236
33038,morcin,asturias,546,308,364,1460,2394,5072
33039,muros,asturias,438,122,296,1132,1896,3884
33040,nava,asturias,1150,610,838,3260,4584,10442
33041,navia,asturias,1990,920,1292,4660,7366,16228
33042,norena,asturias,1560,618,790,3166,4052,10186
33043,onis,asturias,158,70,118,386,734,1466
33044,oviedo,asturias,60750,27498,40614,131610,179582,440054
33045,parres,asturias,1292,626,764,3010,4648,10340
33046,penamellera,asturias,82,38,74,256,582,1032
33047,penamellera,asturias,276,100,186,644,1176,2382
33048,pesoz,asturias,10,8,14,82,158,272
33049,pilona,asturias,1558,644,966,3620,6706,13494
33050,ponga,asturias,72,22,62,318,680,1154
33051,pravia,asturias,1872,936,1232,4442,7096,15578
33052,proaza,asturias,50,54,98,386,760,1348
33053,quiros,asturias,154,74,184,696,1212,2320
33054,"regueras,",asturias,454,140,202,1178,1778,3752
33055,ribadedeva,asturias,426,208,286,956,1528,3404
33056,ribadesella,asturias,1296,632,870,3092,5300,11190
33057,ribera,asturias,500,244,306,1168,1490,3708
33058,riosa,asturias,282,162,282,974,1730,3430
33059,salas,asturias,976,402,748,2482,4970,9578
33060,san,asturias,3296,1594,2308,8498,15094,30790
33061,san,asturias,54,32,22,170,394,672
33062,santa,asturias,76,32,90,192,464,854
33063,san,asturias,66,50,64,200,416,796
33064,santo,asturias,64,20,58,170,272,584
33065,sariego,asturias,298,124,194,786,1124,2526
33066,siero,asturias,15184,6086,8932,33000,41826,105028
33067,sobrescobio,asturias,124,54,148,488,880,1694
33068,somiedo,asturias,106,76,168,572,1228,2150
33069,soto,asturias,768,354,506,2290,3708,7626
33070,tapia,asturias,756,396,526,1956,3508,7142
33071,taramundi,asturias,82,44,82,256,656,1120
33072,teverga,asturias,186,90,200,858,1758,3092
33073,tineo,asturias,1750,876,1426,4582,8916,17550
33074,vegadeo,asturias,890,436,680,2286,3570,7862
33075,villanueva,asturias,52,24,26,136,258,496
33076,villaviciosa,asturias,3776,1620,2148,9098,13978,30620
33077,villayon,asturias,138,104,122,498,1260,2122
33078,yernes,asturias,12,10,20,68,162,272
34001,abarca,palencia,2,4,4,18,48,76
34003,abia,palencia,26,24,34,80,176,340
34004,aguilar,palencia,1886,836,1476,3710,5794,13702
34005,alar,palencia,206,88,182,462,886,1824
34006,alba,palencia,22,0,8,50,84,164
34009,amayuelas,palencia,6,4,0,22,44,76
34010,ampudia,palencia,90,42,132,288,610,1162
34011,amusco,palencia,64,48,60,246,404,822
34012,antiguedad,palencia,12,42,80,150,396,680
34015,arconada,palencia,0,8,2,30,48,88
34017,astudillo,palencia,182,88,188,514,1104,2076
34018,autilla,palencia,28,22,30,124,236,440
34019,autillo,palencia,24,12,12,70,142,260
34020,ayuela,palencia,0,6,2,24,74,106
34022,baltanas,palencia,282,138,222,566,1254,2462
34023,venta,palencia,2130,726,1174,3852,4776,12658
34024,baquerin,palencia,2,2,0,8,30,42
34025,barcena,palencia,0,2,8,14,82,106
34027,barruelo,palencia,220,146,198,522,1240,2326
34028,bascones,palencia,12,10,30,48,166,266
34029,becerril,palencia,154,70,146,416,728,1514
34031,belmonte,palencia,2,2,8,14,34,60
34032,berzosilla,palencia,10,2,6,22,54,94
34033,boada,palencia,0,0,2,8,22,32
34034,boadilla,palencia,10,4,16,66,134,230
34035,boadilla,palencia,14,4,14,48,122,202
34036,branosera,palencia,52,18,34,134,268,506
34037,buenavista,palencia,44,44,48,142,318,596
34038,bustillo,palencia,28,32,32,106,340,538
34039,bustillo,palencia,0,6,2,20,84,112
34041,calahorra,palencia,16,0,12,30,108,166
34042,calzada,palencia,52,44,50,162,312,620
34045,capillas,palencia,8,2,8,36,90,144
34046,cardenosa,palencia,6,16,12,34,52,120
34047,carrion,palencia,550,224,362,1026,1838,4000
34048,castil,palencia,0,2,10,22,76,110
34049,castrejon,palencia,40,20,44,142,394,640
34050,castrillo,palencia,10,28,24,66,242,370
34051,castrillo,palencia,16,2,20,42,102,182
34052,castrillo,palencia,10,6,16,98,208,338
34053,castromocho,palencia,38,16,36,104,200,394
34055,cervatos,palencia,24,8,70,100,280,482
34056,cervera,palencia,580,268,458,1194,2066,4566
34057,cevico,palencia,72,30,78,188,584,952
34058,cevico,palencia,10,12,16,94,224,356
34059,cisneros,palencia,70,44,66,186,496,862
34060,cobos,palencia,12,8,36,54,146,256
34061,collazos,palencia,10,6,30,32,120,198
34062,congosto,palencia,6,4,18,70,182,280
34063,cordovilla,palencia,38,20,20,68,118,264
34066,cubillas,palencia,10,4,14,36,66,130
34067,dehesa,palencia,16,4,22,70,160,272
34068,dehesa,palencia,10,10,10,34,34,98
34069,duenas,palencia,708,286,492,1390,2292,5168
34070,espinosa,palencia,10,6,22,48,160,246
34071,espinosa,palencia,12,14,28,60,196,310
34072,frechilla,palencia,14,8,26,68,156,272
34073,fresno,palencia,12,12,20,86,212,342
34074,fromista,palencia,160,52,116,372,794,1494
34076,fuentes,palencia,90,78,110,292,560,1130
34077,fuentes,palencia,176,38,110,350,294,968
34079,grijota,palencia,1326,334,542,2050,1342,5594
34080,guardo,palencia,1148,650,994,2804,5506,11102
34081,guaza,palencia,8,0,0,30,74,112
34082,hermedes,palencia,0,2,4,34,108,148
34083,herrera,palencia,474,226,298,926,1866,3790
34084,herrera,palencia,26,2,32,74,180,314
34086,hontoria,palencia,10,2,24,78,100,214
34087,hornillos,palencia,44,22,16,92,166,340
34088,husillos,palencia,122,40,74,268,282,786
34089,itero,palencia,14,10,14,70,180,288
34091,lagartos,palencia,20,8,14,54,138,234
34092,lantadilla,palencia,24,32,34,92,364,546
34093,vid,palencia,14,16,14,38,104,186
34094,ledigos,palencia,6,2,20,24,72,124
34096,lomas,palencia,0,6,4,18,54,82
34098,magaz,palencia,316,104,202,730,716,2068
34099,manquillos,palencia,4,0,20,40,52,116
34100,mantinos,palencia,20,8,26,66,172,292
34101,marcilla,palencia,8,2,6,32,68,116
34102,mazariegos,palencia,36,18,38,118,194,404
34103,mazuecos,palencia,2,2,10,38,106,158
34104,melgar,palencia,28,34,50,90,340,542
34106,meneses,palencia,4,8,18,40,132,202
34107,micieces,palencia,0,6,6,22,108,142
34108,monzon,palencia,142,54,136,322,516,1170
34109,moratinos,palencia,2,2,8,22,84,118
34110,muda,palencia,10,2,22,32,94,160
34112,nogal,palencia,12,4,0,24,54,94
34113,olea,palencia,4,2,10,18,44,78
34114,olmos,palencia,4,8,12,78,238,340
34116,osornillo,palencia,4,4,2,30,78,118
34120,palencia,palencia,22164,10138,13886,41936,65032,153156
34121,palenzuela,palencia,36,28,36,118,216,434
34122,paramo,palencia,12,8,22,74,88,204
34123,paredes,palencia,488,248,382,978,1720,3816
34124,payo,palencia,10,4,10,36,54,114
34125,pedraza,palencia,0,4,10,42,88,144
34126,pedrosa,palencia,50,32,40,106,334,562
34127,perales,palencia,10,14,18,42,154,238
34129,pino,palencia,14,10,28,82,192,326
34130,pina,palencia,24,10,36,94,226,390
34131,poblacion,palencia,0,2,2,6,74,84
34132,poblacion,palencia,20,10,24,52,138,244
34133,poblacion,palencia,16,6,16,42,120,200
34134,polentinos,palencia,6,4,4,18,50,82
34135,pomar,palencia,138,44,78,274,440,974
34136,poza,palencia,26,10,18,80,198,332
34137,pozo,palencia,0,0,0,4,32,36
34139,pradanos,palencia,48,22,50,82,160,362
34140,puebla,palencia,2,4,4,18,134,162
34141,quintana,palencia,116,16,40,150,186,508
34143,quintanilla,palencia,30,16,20,88,206,360
34146,reinoso,palencia,6,0,12,26,70,114
34147,renedo,palencia,46,30,20,96,192,384
34149,requena,palencia,2,2,2,18,36,60
34151,respenda,palencia,6,10,16,58,192,282
34152,revenga,palencia,22,22,24,68,138,274
34154,revilla,palencia,4,10,12,32,92,150
34155,ribas,palencia,22,6,44,96,146,314
34156,riberos,palencia,4,6,6,20,72,108
34157,saldana,palencia,790,376,514,1552,2522,5754
34158,salinas,palencia,44,32,64,130,388,658
34159,san,palencia,54,56,90,216,402,818
34160,san,palencia,38,12,18,72,158,298
34161,san,palencia,0,0,4,6,30,40
34163,san,palencia,10,2,8,18,60,98
34165,san,palencia,0,2,10,20,74,106
34167,santa,palencia,6,6,10,52,110,184
34168,santa,palencia,4,6,2,24,68,104
34169,santervas,palencia,80,34,60,196,434,804
34170,santibanez,palencia,0,2,4,20,58,84
34171,santibanez,palencia,140,100,146,422,1060,1868
34174,santoyo,palencia,22,20,24,102,216,384
34175,"serna,",palencia,4,10,24,38,110,186
34176,sotobanado,palencia,48,18,22,72,156,316
34177,soto,palencia,14,8,48,74,208,352
34178,tabanera,palencia,26,14,20,104,112,276
34179,tabanera,palencia,2,2,4,4,34,46
34180,tamara,palencia,14,6,16,32,80,148
34181,tariego,palencia,126,54,116,258,448,1002
34182,torquemada,palencia,292,118,170,526,828,1934
34184,torremormojon,palencia,6,2,2,36,44,90
34185,triollo,palencia,8,4,4,48,84,148
34186,valbuena,palencia,4,4,18,24,54,104
34189,valdeolmillos,palencia,6,8,4,22,80,120
34190,valderrabano,palencia,2,2,4,18,68,94
34192,valde-ucieza,palencia,8,6,12,22,104,152
34196,valle,palencia,4,8,16,40,98,166
34199,velilla,palencia,182,88,178,568,1248,2264
34201,vertavillo,palencia,2,12,24,70,224,332
34202,villabasta,palencia,0,2,10,18,34,64
34204,villacidaler,palencia,2,0,4,12,74,92
34205,villaconancio,palencia,4,4,6,24,62,100
34206,villada,palencia,170,68,114,460,854,1666
34208,villaeles,palencia,4,0,0,32,60,96
34210,villahan,palencia,6,16,10,52,114,198
34211,villaherreros,palencia,42,22,24,114,222,424
34213,villalaco,palencia,8,2,8,30,74,122
34214,villalba,palencia,14,14,30,104,240,402
34215,villalcazar,palencia,24,24,28,76,196,348
34216,villalcon,palencia,0,2,8,18,68,96
34217,villalobon,palencia,898,228,378,1470,830,3804
34218,villaluenga,palencia,148,70,88,206,524,1036
34220,villamartin,palencia,40,28,40,96,136,340
34221,villamediana,palencia,42,4,42,88,190,366
34222,villameriel,palencia,12,2,18,44,134,210
34223,villamoronta,palencia,46,24,78,102,238,488
34224,villamuera,palencia,2,0,6,14,52,74
34225,villamuriel,palencia,2512,878,1240,4272,4102,13004
34227,villanueva,palencia,2,4,16,24,88,134
34228,villanuno,palencia,16,6,14,32,114,182
34229,villaprovedo,palencia,2,0,4,10,78,94
34230,villarmentero,palencia,4,6,6,10,30,56
34231,villarrabe,palencia,2,14,20,72,246,354
34232,villarramiel,palencia,114,100,160,372,832,1578
34233,villasarracino,palencia,8,4,12,68,174,266
34234,villasila,palencia,4,4,14,26,72,120
34236,villaturde,palencia,14,20,12,62,186,294
34237,villaumbrales,palencia,126,80,114,344,584,1248
34238,villaviudas,palencia,68,66,68,152,376,730
34240,villerias,palencia,2,6,14,36,94,152
34241,villodre,palencia,4,2,4,8,30,48
34242,villodrigo,palencia,6,10,32,42,110,200
34243,villoldo,palencia,50,36,68,140,384,678
34245,villota,palencia,26,38,26,124,386,600
34246,villovieco,palencia,6,4,12,18,84,124
34901,osorno,palencia,236,152,196,562,1234,2380
34902,valle,palencia,54,22,22,98,142,338
34903,loma,palencia,16,20,14,80,254,384
34904,"pernia,",palencia,42,26,36,170,350,624
35001,agaete,"palmas,",1352,762,1216,3746,4314,11390
35002,aguimes,"palmas,",10998,5336,7850,23442,18986,66612
35003,antigua,"palmas,",3900,1654,3112,8992,9832,27490
35004,arrecife,"palmas,",23540,12266,20114,45018,35112,136050
35005,artenara,"palmas,",106,100,240,570,1046,2062
35006,arucas,"palmas,",11272,6122,8856,25690,25914,77854
35007,betancuria,"palmas,",224,114,216,476,578,1608
35008,firgas,"palmas,",2126,1258,1730,4960,5428,15502
35009,galdar,"palmas,",6638,4016,5948,15562,17534,49698
35010,haria,"palmas,",1412,710,1310,3526,4222,11180
35011,ingenio,"palmas,",10178,5158,8034,22574,19352,65296
35012,mogan,"palmas,",6272,3156,5450,13544,14102,42524
35013,moya,"palmas,",2160,1132,1676,4996,5994,15958
35014,"oliva,","palmas,",9328,4064,8144,22062,15734,59332
35015,pajara,"palmas,",7286,4066,6400,14376,10150,42278
35016,palmas,"palmas,",102904,61092,91888,237004,274144,767032
35017,puerto,"palmas,",15990,7890,12708,30964,22042,89594
35018,san,"palmas,",6320,3198,5034,13500,11276,39328
35019,san,"palmas,",14464,7710,12982,36830,37966,109952
35020,aldea,"palmas,",1818,1286,1836,4528,5434,14902
35021,santa,"palmas,",5130,2844,4084,11076,14126,37260
35022,santa,"palmas,",26208,14018,21082,52670,42118,156096
35023,santa,"palmas,",3566,2216,3322,8770,10482,28356
35024,teguise,"palmas,",7534,3778,5218,16228,14766,47524
35025,tejeda,"palmas,",262,160,382,990,1864,3658
35026,telde,"palmas,",30330,17332,23984,69556,65972,207174
35027,teror,"palmas,",3470,1916,2996,8218,9218,25818
35028,tias,"palmas,",6364,2972,5572,13912,14092,42912
35029,tinajo,"palmas,",2412,1190,1626,4618,3818,13664
35030,tuineje,"palmas,",5828,2878,4440,11014,8890,33050
35031,valsequillo,"palmas,",2918,1718,2438,6248,6246,19568
35032,valleseco,"palmas,",770,406,754,2350,3258,7538
35033,vega,"palmas,",1936,1110,1784,5014,5874,15718
35034,yaiza,"palmas,",6128,3028,5190,12378,9078,35802
36001,arbo,pontevedra,524,262,400,1400,2740,5326
36002,barro,pontevedra,1190,412,624,2304,2816,7346
36003,baiona,pontevedra,3476,1626,2220,8008,9662,24992
36004,bueu,pontevedra,3252,1494,2374,7250,9290,23660
36005,caldas,pontevedra,2670,1246,1960,5840,7518,19234
36006,cambados,pontevedra,4138,2006,2714,8642,10168,27668
36007,campo,pontevedra,294,196,278,842,1790,3400
36008,cangas,pontevedra,7584,3582,4604,17092,20600,53462
36009,"caniza,",pontevedra,1224,608,826,2824,4622,10104
36010,catoira,pontevedra,884,426,562,2086,2578,6536
36013,covelo,pontevedra,466,220,308,1276,2560,4830
36014,crecente,pontevedra,236,148,310,892,2292,3878
36015,cuntis,pontevedra,1038,458,744,2614,4166,9020
36016,dozon,pontevedra,134,92,160,484,1078,1948
36017,"estrada,",pontevedra,5210,2378,3466,11566,17646,40266
36018,forcarei,pontevedra,522,288,468,1578,3432,6288
36019,fornelos,pontevedra,350,152,278,916,1556,3252
36020,agolada,pontevedra,362,202,370,1074,2562,4570
36021,gondomar,pontevedra,4668,2116,2860,9986,10732,30362
36022,"grove,",pontevedra,2968,1494,2056,6600,8654,21772
36023,"guarda,",pontevedra,2810,1212,1942,5904,8260,20128
36024,lalin,pontevedra,5634,2314,3944,12106,16502,40500
36025,"lama,",pontevedra,462,262,436,1326,2586,5072
36026,marin,pontevedra,7046,3520,4618,14322,18672,48178
36027,meano,pontevedra,1532,690,984,3170,4152,10528
36028,meis,pontevedra,1236,600,790,2798,3992,9416
36029,moana,pontevedra,5682,2558,3254,12276,14838,38608
36030,mondariz,pontevedra,994,462,716,2582,4124,8878
36031,mondariz-balneario,pontevedra,192,82,186,456,532,1448
36032,morana,pontevedra,1168,534,654,2622,3278,8256
36033,mos,pontevedra,4666,1968,2684,9606,11346,30270
36034,"neves,",pontevedra,822,406,620,2076,3428,7352
36035,nigran,pontevedra,5244,2360,3356,11066,14374,36400
36036,oia,pontevedra,774,354,468,1842,2712,6150
36037,pazos,pontevedra,802,348,506,1818,2524,5998
36038,pontevedra,pontevedra,25570,11524,16152,50966,62000,166212
36039,"porrino,",pontevedra,7012,2682,4538,14234,12940,41406
36040,portas,pontevedra,716,340,474,1602,2428,5560
36041,poio,pontevedra,5572,2484,3284,11200,12284,34824
36042,ponteareas,pontevedra,7552,3656,4248,15352,15608,46416
36043,ponte,pontevedra,1512,706,1004,3266,4676,11164
36044,pontecesures,pontevedra,886,420,762,2046,2068,6182
36045,redondela,pontevedra,8100,3724,5240,17810,23188,58062
36046,ribadumia,pontevedra,1820,648,1084,3400,3464,10416
36047,rodeiro,pontevedra,390,188,426,1124,2424,4552
36048,"rosal,",pontevedra,1744,806,1304,3924,5352,13130
36049,salceda,pontevedra,3610,1212,1890,6742,5360,18814
36050,salvaterra,pontevedra,3174,1246,2028,6946,7524,20918
36051,sanxenxo,pontevedra,4946,2350,3400,11128,13972,35796
36052,silleda,pontevedra,2354,958,1592,5342,7514,17760
36053,soutomaior,pontevedra,2682,958,1414,5230,4880,15164
36054,tomino,pontevedra,3996,1866,2612,8752,10486,27712
36055,tui,pontevedra,5394,2522,3366,11054,12740,35076
36056,valga,pontevedra,1630,714,1018,3436,4568,11366
36057,vigo,pontevedra,84848,39834,58224,179526,228614,591046
36058,vilaboa,pontevedra,1572,780,896,3478,5032,11758
36059,vila,pontevedra,1142,420,870,2484,5146,10062
36060,vilagarcia,pontevedra,11108,5144,7452,23484,28474,75662
36061,vilanova,pontevedra,2850,1326,1874,6108,8318,20476
36901,illa,pontevedra,1350,682,944,3020,3710,9706
36902,cerdedo-cotobade,pontevedra,1290,526,888,3128,5570,11402
37001,abusejo,salamanca,12,4,14,52,202,284
37002,agallas,salamanca,2,18,14,42,188,264
37003,ahigal,salamanca,8,4,4,24,136,176
37004,ahigal,salamanca,6,0,2,18,36,62
37005,alameda,salamanca,4,4,4,14,118,144
37006,"alamedilla,",salamanca,8,6,2,34,150,200
37007,alaraz,salamanca,72,52,100,202,468,894
37008,alba,salamanca,1566,692,972,3040,3974,10244
37009,alba,salamanca,16,12,26,90,262,406
37010,"alberca,",salamanca,252,140,212,542,940,2086
37011,albergueria,salamanca,12,10,6,32,136,196
37012,alconada,salamanca,14,8,20,56,170,268
37013,aldeacipreste,salamanca,6,6,16,36,118,182
37014,aldeadavila,salamanca,104,86,184,450,1420,2244
37015,aldea,salamanca,28,20,36,116,310,510
37016,aldealengua,salamanca,188,98,148,448,544,1426
37017,aldeanueva,salamanca,20,32,34,116,304,506
37018,aldeanueva,salamanca,4,4,20,50,118,196
37019,aldearrodrigo,salamanca,10,20,26,70,174,300
37020,aldearrubia,salamanca,136,66,86,302,448,1038
37021,aldeaseca,salamanca,16,2,2,34,74,128
37022,aldeaseca,salamanca,30,18,22,136,290,496
37023,aldeatejada,salamanca,1272,308,382,2104,1122,5188
37024,aldeavieja,salamanca,22,4,24,52,96,198
37025,aldehuela,salamanca,38,42,40,146,268,534
37026,aldehuela,salamanca,22,10,22,70,238,362
37027,almenara,salamanca,90,40,66,190,234,620
37028,almendra,salamanca,14,8,18,42,182,264
37029,anaya,salamanca,22,12,24,84,228,370
37030,anover,salamanca,12,12,6,48,100,178
37031,arabayona,salamanca,40,38,54,156,360,648
37032,arapiles,salamanca,270,38,168,484,522,1482
37033,arcediano,salamanca,12,8,24,50,98,192
37034,"arco,",salamanca,22,12,16,54,82,186
37035,armenteros,salamanca,26,42,26,80,202,376
37036,san,salamanca,2,2,0,18,64,86
37037,"atalaya,",salamanca,14,4,16,54,112,200
37038,babilafuente,salamanca,306,102,190,528,738,1864
37039,banobarez,salamanca,42,12,44,112,346,556
37040,barbadillo,salamanca,46,34,62,196,452,790
37041,barbalos,salamanca,0,2,14,32,98,146
37042,barceo,salamanca,12,4,0,18,62,96
37044,barruecopardo,salamanca,34,40,94,166,506,840
37045,"bastida,",salamanca,0,0,8,14,32,54
37046,bejar,salamanca,3012,1582,1894,5884,11526,23898
37047,belena,salamanca,58,10,34,84,326,512
37049,bermellar,salamanca,10,8,4,74,166,262
37050,berrocal,salamanca,8,10,6,28,98,150
37051,berrocal,salamanca,0,2,8,38,90,138
37052,boada,salamanca,58,20,32,138,290,538
37054,"bodon,",salamanca,40,26,30,92,302,490
37055,bogajo,salamanca,14,14,34,48,146,256
37056,"bouza,",salamanca,24,2,8,16,48,98
37057,boveda,salamanca,34,26,34,98,202,394
37058,brincones,salamanca,2,6,2,24,84,118
37059,buenamadre,salamanca,14,10,16,42,136,218
37060,buenavista,salamanca,84,56,84,196,312,732
37061,"cabaco,",salamanca,32,22,26,110,260,450
37062,cabezabellosa,salamanca,2,8,18,44,76,148
37063,cabeza,salamanca,6,4,4,24,82,120
37065,cabeza,salamanca,16,18,34,94,312,474
37067,cabrerizos,salamanca,1480,870,704,2422,2978,8454
37068,cabrillas,salamanca,42,10,36,162,394,644
37069,calvarrasa,salamanca,334,150,244,770,922,2420
37070,calvarrasa,salamanca,110,70,122,316,608,1226
37071,calzada,salamanca,20,4,14,36,96,170
37072,calzada,salamanca,12,6,22,56,170,266
37073,calzada,salamanca,172,92,138,436,560,1398
37074,campillo,salamanca,6,8,24,54,194,286
37077,campo,salamanca,30,6,24,130,306,496
37078,candelario,salamanca,142,82,98,422,942,1686
37079,canillas,salamanca,12,8,8,52,58,138
37080,cantagallo,salamanca,86,32,52,170,220,560
37081,cantalapiedra,salamanca,156,52,138,432,1008,1786
37082,cantalpino,salamanca,198,86,120,428,772,1604
37083,cantaracillo,salamanca,36,16,30,88,210,380
37085,carbajosa,salamanca,3616,1402,1366,5678,3214,15276
37086,carpio,salamanca,16,12,16,66,114,224
37087,carrascal,salamanca,666,184,242,1104,680,2876
37088,carrascal,salamanca,16,18,26,88,228,376
37089,casafranca,salamanca,2,6,10,30,86,134
37090,casas,salamanca,10,4,4,36,72,126
37091,casillas,salamanca,16,16,8,70,224,334
37092,castellanos,salamanca,1562,284,612,2644,998,6100
37096,castillejo,salamanca,36,12,40,92,230,410
37097,castraz,salamanca,0,2,6,6,54,68
37098,cepeda,salamanca,36,18,56,110,386,606
37099,cereceda,salamanca,4,2,6,28,84,124
37100,cerezal,salamanca,2,2,10,30,90,134
37101,cerralbo,salamanca,8,2,12,26,176,224
37102,"cerro,",salamanca,44,28,42,138,488,740
37103,cespedosa,salamanca,148,70,74,270,436,998
37104,cilleros,salamanca,0,0,6,8,32,46
37106,ciperez,salamanca,14,16,34,98,288,450
37107,ciudad,salamanca,3036,1462,1934,5944,11266,23642
37108,coca,salamanca,16,2,14,46,112,190
37109,colmenar,salamanca,12,24,26,68,218,348
37110,cordovilla,salamanca,16,10,30,44,116,216
37112,cristobal,salamanca,12,18,30,72,192,324
37113,cubo,salamanca,56,40,82,162,418,758
37114,chagarcia,salamanca,2,10,10,24,96,142
37115,dios,salamanca,14,32,16,44,146,252
37116,doninos,salamanca,6,6,16,40,64,132
37117,doninos,salamanca,1110,288,336,1814,1050,4598
37118,ejeme,salamanca,18,6,24,78,162,288
37119,"encina,",salamanca,6,8,14,40,130,198
37120,encina,salamanca,18,12,12,50,126,218
37121,encinas,salamanca,182,58,108,348,540,1236
37122,encinas,salamanca,54,40,42,134,182,452
37123,encinasola,salamanca,2,8,20,54,212,296
37124,endrinal,salamanca,18,24,36,100,230,408
37125,escurial,salamanca,16,36,44,86,308,490
37126,espadana,salamanca,0,4,12,2,48,66
37127,espeja,salamanca,28,22,34,92,246,422
37128,espino,salamanca,46,12,34,122,274,488
37129,florida,salamanca,18,20,38,140,272,488
37130,forfoleda,salamanca,34,22,36,92,224,408
37131,frades,salamanca,2,10,30,74,218,334
37132,"fregeneda,",salamanca,40,12,36,134,394,616
37133,fresnedoso,salamanca,10,0,20,40,126,196
37134,fresno,salamanca,16,10,42,94,202,364
37135,fuente,salamanca,300,98,192,688,1290,2568
37136,fuenteguinaldo,salamanca,134,54,94,284,738,1304
37137,fuenteliante,salamanca,6,6,10,42,110,174
37138,fuenterroble,salamanca,60,46,76,128,194,504
37139,fuentes,salamanca,66,22,48,134,218,488
37140,fuentes,salamanca,196,90,180,638,938,2042
37141,gajates,salamanca,16,12,20,56,176,280
37142,galindo,salamanca,210,94,90,460,568,1422
37143,galinduste,salamanca,78,58,62,192,410,800
37144,galisancho,salamanca,56,24,38,176,364,658
37145,gallegos,salamanca,42,26,32,114,306,520
37146,gallegos,salamanca,20,8,10,42,138,218
37147,garcibuey,salamanca,28,14,30,82,254,408
37148,garcihernandez,salamanca,40,64,84,206,428,822
37149,garcirrey,salamanca,2,0,6,24,78,110
37150,gejuelo,salamanca,2,0,4,18,38,62
37151,golpejas,salamanca,16,10,26,78,158,288
37152,gomecello,salamanca,70,44,46,248,416,824
37154,guadramiro,salamanca,24,4,22,66,132,248
37155,guijo,salamanca,16,2,6,44,90,158
37156,guijuelo,salamanca,1862,912,1370,3118,3832,11094
37157,herguijuela,salamanca,0,0,12,32,94,138
37158,herguijuela,salamanca,18,30,38,82,284,452
37159,herguijuela,salamanca,4,0,6,30,84,124
37160,hinojosa,salamanca,62,82,80,256,674,1154
37161,horcajo,salamanca,12,6,12,42,130,202
37162,horcajo,salamanca,18,18,32,108,242,418
37163,"hoya,",salamanca,4,2,4,20,32,62
37164,huerta,salamanca,100,18,76,158,218,570
37165,iruelos,salamanca,4,4,0,16,38,62
37166,ituero,salamanca,10,22,24,64,278,398
37167,juzbado,salamanca,42,22,32,108,160,364
37168,lagunilla,salamanca,68,40,64,170,522,864
37169,larrodrigo,salamanca,10,30,24,90,218,372
37170,ledesma,salamanca,344,150,288,786,1472,3040
37171,ledrada,salamanca,104,70,80,250,424,928
37172,linares,salamanca,150,78,190,440,986,1844
37173,lumbrales,salamanca,290,178,244,660,1650,3022
37174,macotera,salamanca,88,94,140,420,1264,2006
37175,machacon,salamanca,76,58,82,260,412,888
37176,madronal,salamanca,14,20,12,62,162,270
37177,"maillo,",salamanca,46,22,40,118,336,562
37178,malpartida,salamanca,0,4,12,24,120,160
37179,mancera,salamanca,16,16,30,72,260,394
37180,"manzano,",salamanca,0,0,4,16,96,116
37181,martiago,salamanca,24,22,24,104,324,498
37182,martinamor,salamanca,12,8,22,62,62,166
37183,martin,salamanca,50,12,62,194,456,774
37184,masueco,salamanca,12,12,30,70,376,500
37185,castellanos,salamanca,192,74,104,418,620,1408
37186,mata,salamanca,6,6,18,52,120,202
37187,matilla,salamanca,168,72,104,378,522,1244
37188,"maya,",salamanca,12,12,28,54,208,314
37189,membribe,salamanca,8,10,8,58,126,210
37190,mieza,salamanca,4,10,12,48,278,352
37191,"milano,",salamanca,12,6,14,32,112,176
37192,miranda,salamanca,154,26,94,326,292,892
37193,miranda,salamanca,48,40,52,152,468,760
37194,mogarraz,salamanca,42,22,58,118,270,510
37195,molinillo,salamanca,2,2,4,26,62,96
37196,monforte,salamanca,0,0,2,20,86,108
37197,monleon,salamanca,14,6,6,54,98,178
37198,monleras,salamanca,50,46,44,150,200,490
37199,monsagro,salamanca,16,14,16,76,134,256
37200,montejo,salamanca,28,28,36,112,190,394
37201,montemayor,salamanca,44,18,22,112,324,520
37202,monterrubio,salamanca,536,258,188,956,736,2674
37203,monterrubio,salamanca,8,12,16,68,194,298
37204,morasverdes,salamanca,24,12,40,100,294,470
37205,morille,salamanca,24,22,38,126,238,448
37206,morinigo,salamanca,8,6,16,44,102,176
37207,moriscos,salamanca,260,48,110,494,222,1134
37208,moronta,salamanca,0,6,8,36,102,152
37209,mozarbez,salamanca,120,70,96,304,430,1020
37211,narros,salamanca,16,20,26,82,256,400
37212,navacarros,salamanca,24,20,18,74,130,266
37213,nava,salamanca,4,2,14,34,92,146
37214,nava,salamanca,12,14,12,48,152,238
37215,nava,salamanca,36,20,24,72,168,320
37216,navales,salamanca,52,28,56,152,336,624
37217,navalmoral,salamanca,6,0,8,26,72,112
37218,navamorales,salamanca,0,0,2,18,68,88
37219,navarredonda,salamanca,10,8,22,62,202,304
37221,navasfrias,salamanca,48,36,34,168,438,724
37222,negrilla,salamanca,8,4,10,44,86,152
37223,olmedo,salamanca,6,10,18,26,130,190
37224,"orbada,",salamanca,10,24,34,68,228,364
37225,pajares,salamanca,22,14,14,58,122,230
37226,palacios,salamanca,6,12,34,70,178,300
37228,palaciosrubios,salamanca,18,26,46,120,388,598
37229,palencia,salamanca,30,14,12,54,168,278
37230,parada,salamanca,70,26,44,170,232,542
37231,parada,salamanca,36,18,34,110,284,482
37232,paradinas,salamanca,32,36,88,154,458,768
37233,pastores,salamanca,2,0,6,24,80,112
37234,"payo,",salamanca,38,28,30,128,404,628
37235,pedraza,salamanca,38,30,58,90,228,444
37236,pedrosillo,salamanca,14,8,6,50,170,248
37237,pedrosillo,salamanca,56,28,40,184,310,618
37238,pedrosillo,salamanca,30,14,24,76,126,270
37239,pedroso,salamanca,10,30,44,90,248,422
37240,pelabravo,salamanca,482,162,296,910,880,2730
37241,pelarrodriguez,salamanca,12,14,36,74,182,318
37242,pelayos,salamanca,2,2,10,34,96,144
37243,"pena,",salamanca,0,6,4,28,102,140
37244,penacaballera,salamanca,40,14,24,78,150,306
37245,penaparda,salamanca,28,24,50,100,410,612
37246,penaranda,salamanca,1722,848,1060,3418,5148,12196
37247,penarandilla,salamanca,20,16,34,90,204,364
37248,peralejos,salamanca,22,14,40,80,186,342
37249,peralejos,salamanca,0,2,8,10,50,70
37250,perena,salamanca,24,22,44,122,416,628
37251,peromingo,salamanca,30,8,44,56,106,244
37252,pinedas,salamanca,4,4,10,34,136,188
37253,pino,salamanca,28,16,26,92,136,298
37254,pitiegua,salamanca,22,10,38,78,218,366
37255,pizarral,salamanca,6,8,20,28,66,128
37256,poveda,salamanca,24,10,26,82,252,394
37257,pozos,salamanca,4,10,4,16,70,104
37258,puebla,salamanca,18,10,18,42,202,290
37259,puebla,salamanca,0,2,8,14,42,66
37260,puebla,salamanca,28,12,8,74,162,284
37261,puente,salamanca,28,12,10,122,278,450
37262,puertas,salamanca,14,2,12,32,72,132
37263,puerto,salamanca,56,30,36,172,418,712
37264,puerto,salamanca,4,0,4,24,78,110
37265,ragama,salamanca,12,24,42,70,246,394
37266,"redonda,",salamanca,8,6,14,34,68,130
37267,retortillo,salamanca,28,18,30,88,186,350
37268,rinconada,salamanca,4,2,8,34,152,200
37269,robleda,salamanca,86,38,90,218,478,910
37270,robliza,salamanca,30,22,44,114,182,392
37271,rollan,salamanca,38,14,62,150,410,674
37272,saelices,salamanca,68,10,18,114,134,344
37273,"sagrada,",salamanca,8,4,12,26,118,168
37274,salamanca,salamanca,38956,20708,30070,72994,126188,288916
37275,saldeana,salamanca,10,0,8,24,156,198
37276,salmoral,salamanca,4,0,10,54,154,222
37277,salvatierra,salamanca,6,2,6,36,96,146
37278,san,salamanca,400,172,218,870,632,2292
37279,sancti-spiritus,salamanca,128,72,122,364,784,1470
37280,sanchon,salamanca,10,8,4,30,82,134
37281,sanchon,salamanca,6,6,10,26,54,102
37282,sanchotello,salamanca,40,20,36,114,218,428
37283,sando,salamanca,6,8,16,74,122,226
37284,san,salamanca,64,22,58,188,414,746
37285,san,salamanca,36,16,66,124,458,700
37286,san,salamanca,18,24,30,102,292,466
37287,san,salamanca,70,22,40,164,316,612
37288,san,salamanca,128,48,64,218,270,728
37289,san,salamanca,22,10,30,100,248,410
37290,san,salamanca,22,6,28,84,152,292
37291,san,salamanca,28,28,58,150,276,540
37292,san,salamanca,12,12,30,38,92,184
37293,santa,salamanca,4,6,8,42,130,190
37294,santa,salamanca,4634,2346,3160,8354,10920,29414
37296,santiago,salamanca,12,20,32,124,376,564
37297,santibanez,salamanca,78,48,92,228,442,888
37298,santibanez,salamanca,20,4,24,76,174,298
37299,santiz,salamanca,28,36,22,114,258,458
37300,"santos,",salamanca,104,56,108,302,588,1158
37301,sardon,salamanca,12,8,12,50,120,202
37302,saucelle,salamanca,28,26,30,126,296,506
37303,"sahugo,",salamanca,18,26,20,52,246,362
37304,sepulcro-hilario,salamanca,22,6,16,72,194,310
37305,sequeros,salamanca,24,18,26,92,256,416
37306,serradilla,salamanca,42,12,32,120,286,492
37307,serradilla,salamanca,14,16,18,68,160,276
37309,"sierpe,",salamanca,4,8,8,12,54,86
37310,sieteiglesias,salamanca,28,12,12,52,224,328
37311,sobradillo,salamanca,22,4,26,76,218,346
37312,sorihuela,salamanca,44,28,32,148,262,514
37313,sotoserrano,salamanca,50,42,82,242,614,1030
37314,tabera,salamanca,28,26,4,66,74,198
37315,"tala,",salamanca,6,4,10,38,94,152
37316,tamames,salamanca,132,80,144,404,814,1574
37317,tarazona,salamanca,12,30,42,120,334,538
37318,tardaguila,salamanca,16,22,28,82,244,392
37319,"tejado,",salamanca,8,4,20,28,106,166
37320,tejeda,salamanca,18,6,20,42,110,196
37321,tenebron,salamanca,8,6,16,40,174,244
37322,terradillos,salamanca,1098,470,786,1834,2238,6426
37323,topas,salamanca,106,46,102,306,464,1024
37324,tordillos,salamanca,18,16,36,136,428,634
37325,"tornadizo,",salamanca,0,4,16,36,116,172
37327,torresmenudas,salamanca,18,16,36,90,212,372
37328,trabanca,salamanca,38,16,26,78,190,348
37329,tremedal,salamanca,2,2,6,20,40,70
37330,valdecarros,salamanca,48,22,54,146,348,618
37331,valdefuentes,salamanca,20,6,18,82,252,378
37332,valdehijaderos,salamanca,22,4,16,42,84,168
37333,valdelacasa,salamanca,24,30,30,88,210,382
37334,valdelageve,salamanca,10,4,12,30,78,134
37335,valdelosa,salamanca,78,44,64,214,408,808
37336,valdemierque,salamanca,12,8,12,32,54,118
37337,valderrodrigo,salamanca,6,14,38,48,148,254
37338,valdunciel,salamanca,30,18,10,70,90,218
37339,valero,salamanca,40,26,34,154,322,576
37340,valsalabroso,salamanca,4,4,30,52,148,238
37341,valverde,salamanca,10,4,4,34,62,114
37342,valverdon,salamanca,60,22,52,146,250,530
37343,vallejera,salamanca,14,10,22,32,66,144
37344,vecinos,salamanca,40,18,50,106,226,440
37345,vega,salamanca,22,4,18,94,154,292
37346,"veguillas,",salamanca,66,10,40,150,282,548
37347,"velles,",salamanca,144,70,104,338,434,1090
37348,ventosa,salamanca,8,10,14,40,126,198
37349,"vidola,",salamanca,8,4,18,44,128,202
37350,vilvestre,salamanca,46,20,50,174,502,792
37351,villaflores,salamanca,24,24,42,96,334,520
37352,villagonzalo,salamanca,36,16,52,142,190,436
37353,villalba,salamanca,4,6,26,52,132,220
37354,villamayor,salamanca,3054,1318,1404,5058,4504,15338
37355,villanueva,salamanca,20,14,20,68,226,348
37356,villar,salamanca,8,8,16,40,122,194
37357,villar,salamanca,30,8,26,88,354,506
37358,villar,salamanca,12,26,30,130,194,392
37359,villar,salamanca,4,8,14,50,234,310
37360,villar,salamanca,28,26,28,100,228,410
37361,villar,salamanca,10,8,12,28,98,156
37362,villares,salamanca,2906,992,1286,4782,3474,13440
37363,villares,salamanca,6,4,12,40,134,196
37364,villarino,salamanca,70,58,130,270,952,1480
37365,villarmayor,salamanca,18,20,20,86,164,308
37366,villarmuerto,salamanca,0,0,4,14,62,80
37367,villasbuenas,salamanca,10,8,18,62,230,328
37368,villasdardo,salamanca,10,2,4,8,20,44
37369,villaseco,salamanca,16,20,26,92,122,276
37370,villaseco,salamanca,10,22,52,138,374,596
37371,villasrubias,salamanca,16,18,26,98,314,472
37372,villaverde,salamanca,20,10,8,62,180,280
37373,villavieja,salamanca,78,84,110,308,794,1374
37374,villoria,salamanca,288,186,224,648,1170,2516
37375,villoruela,salamanca,144,66,108,322,822,1462
37376,vitigudino,salamanca,612,288,450,1126,2240,4716
37377,yecla,salamanca,28,16,28,126,246,444
37378,zamarra,salamanca,0,2,4,24,112,142
37379,zamayon,salamanca,50,26,38,116,154,384
37380,zarapicos,salamanca,6,0,6,38,48,98
37381,zarza,salamanca,4,8,18,52,184,266
37382,zorita,salamanca,4,14,12,72,198,300
38001,adeje,santa,16202,7762,14542,36406,26946,101858
38002,agulo,santa,162,152,248,538,1144,2244
38003,alajero,santa,484,308,466,1284,1632,4174
38004,arafo,santa,1776,922,1106,3930,3922,11656
38005,arico,santa,2556,1248,2094,6378,6082,18358
38006,arona,santa,26568,13318,24838,59312,51660,175696
38007,barlovento,santa,468,286,412,1152,1812,4130
38008,brena,santa,2160,1104,1654,4562,5384,14864
38009,brena,santa,1816,738,1408,4062,4200,12224
38010,buenavista,santa,1082,568,896,2836,4002,9384
38011,candelaria,santa,9040,4060,6364,19414,19106,57984
38012,fasnia,santa,712,394,574,2000,2462,6142
38013,frontera,santa,1268,642,1142,2696,3302,9050
38014,fuencaliente,santa,484,266,510,1068,1494,3822
38015,garachico,santa,1256,592,882,2848,4354,9932
38016,garafia,santa,462,190,418,1226,1702,3998
38017,granadilla,santa,19840,9462,15960,40674,29352,115288
38018,"guancha,",santa,1644,756,1166,3396,4246,11208
38019,guia,santa,7100,3942,6000,14638,13936,45616
38020,guimar,santa,6568,2976,4826,14962,14138,43470
38021,hermigua,santa,314,274,426,1042,1726,3782
38022,icod,santa,6860,3416,5382,14738,18508,48904
38023,san,santa,44232,27140,41064,100808,108466,321710
38024,llanos,santa,5904,3186,4922,12882,14030,40924
38025,matanza,santa,2812,1280,2032,6444,5802,18370
38026,"orotava,",santa,12984,7016,9534,26654,29270,85458
38027,"paso,",santa,2252,1172,1824,4964,6092,16304
38028,puerto,santa,7350,3738,6994,18574,26990,63646
38029,puntagorda,santa,606,322,560,1388,1822,4698
38030,puntallana,santa,762,422,520,1614,2092,5410
38031,"realejos,",santa,11318,5934,8376,23832,26322,75782
38032,"rosario,",santa,5324,2692,4000,12156,11848,36020
38033,san,santa,946,554,832,2414,3850,8596
38034,san,santa,1404,660,1036,3140,3638,9878
38035,san,santa,8166,3668,6104,16404,12746,47088
38036,san,santa,2802,1548,2310,5822,6808,19290
38037,santa,santa,3812,2338,3800,9234,12116,31300
38038,santa,santa,57896,31670,50312,131148,149946,420972
38039,santa,santa,4720,2358,3468,9970,9986,30502
38040,santiago,santa,3964,1664,3198,7924,8244,24994
38041,"sauzal,",santa,2766,1414,1992,5790,6640,18602
38042,"silos,",santa,1188,578,940,2804,3906,9416
38043,tacoronte,santa,7610,3740,5192,16414,16596,49552
38044,"tanque,",santa,840,418,632,1630,2098,5618
38045,tazacorte,santa,992,704,1028,2686,3646,9056
38046,tegueste,santa,3370,1688,2420,7300,8080,22858
38047,tijarafe,santa,560,350,546,1512,2360,5328
38048,valverde,santa,1380,640,1256,3126,4082,10484
38049,valle,santa,1024,648,960,2790,4170,9592
38050,vallehermoso,santa,462,340,578,1554,2998,5932
38051,victoria,santa,2756,1342,2098,6238,6216,18650
38052,vilaflor,santa,444,290,464,1130,1438,3766
38053,villa,santa,1350,722,1164,3006,3868,10110
38901,pinar,santa,400,298,468,1160,1712,4038
39001,alfoz,cantabria,610,286,434,1420,2254,5004
39002,ampuero,cantabria,1416,638,684,2842,3362,8942
39003,anievas,cantabria,40,28,42,128,314,552
39004,arenas,cantabria,456,154,340,972,1590,3512
39005,argonos,cantabria,574,272,324,1154,1422,3746
39006,arnuero,cantabria,602,296,398,1358,1890,4544
39007,arredondo,cantabria,88,40,58,294,474,954
39008,"astillero,",cantabria,6194,2568,3298,12306,12540,36906
39009,barcena,cantabria,1572,600,896,3222,3180,9470
39010,barcena,cantabria,124,58,114,350,702,1348
39011,bareyo,cantabria,642,216,408,1344,1656,4266
39012,cabezon,cantabria,2634,1056,1466,4884,6520,16560
39013,cabezon,cantabria,98,56,58,286,582,1080
39014,cabuerniga,cantabria,194,94,140,572,1002,2002
39015,camaleno,cantabria,206,110,178,516,934,1944
39016,camargo,cantabria,9270,4882,5030,18582,23086,60850
39017,campoo,cantabria,204,70,86,400,588,1348
39018,cartes,cantabria,2466,850,1082,4422,2906,11726
39019,castaneda,cantabria,1202,380,692,2462,1758,6494
39020,castro-urdiales,cantabria,11140,5068,5684,22668,22170,66730
39021,cieza,cantabria,134,68,80,284,522,1088
39022,cillorigo,cantabria,338,194,246,784,1160,2722
39023,colindres,cantabria,2796,1364,1582,5348,5982,17072
39024,comillas,cantabria,510,250,356,1200,1966,4282
39025,corrales,cantabria,3228,1594,1812,6626,8338,21598
39026,corvera,cantabria,524,246,426,1298,1786,4280
39027,campoo,cantabria,1208,432,568,2306,2950,7464
39028,entrambasaguas,cantabria,2384,588,1034,4320,2930,11256
39029,escalante,cantabria,166,88,126,380,712,1472
39030,guriezo,cantabria,764,270,392,1702,1788,4916
39031,hazas,cantabria,616,240,398,1264,1212,3730
39032,hermandad,cantabria,358,170,220,962,1522,3232
39033,herrerias,cantabria,76,44,78,310,654,1162
39034,lamason,cantabria,28,12,26,124,306,496
39035,laredo,cantabria,2628,1236,1612,6034,9966,21476
39036,liendo,cantabria,356,156,138,740,1066,2456
39037,lierganes,cantabria,594,276,390,1430,2098,4788
39038,limpias,cantabria,610,226,356,1278,1538,4008
39039,luena,cantabria,106,50,94,328,636,1214
39040,marina,cantabria,1370,644,894,2978,4502,10388
39041,mazcuerras,cantabria,618,266,356,1276,1662,4178
39042,medio,cantabria,2418,1146,1480,4804,5500,15348
39043,meruelo,cantabria,842,306,458,1574,1422,4602
39044,miengo,cantabria,1536,552,1058,3758,3564,10468
39045,miera,cantabria,88,20,60,234,398,800
39046,molledo,cantabria,310,124,220,812,1506,2972
39047,noja,cantabria,748,400,510,1706,2008,5372
39048,penagos,cantabria,780,224,396,1520,1594,4514
39049,penarrubia,cantabria,42,40,52,156,372,662
39050,pesaguero,cantabria,64,18,22,166,280,550
39051,pesquera,cantabria,6,12,14,32,76,140
39052,pielagos,cantabria,10834,3820,4416,19222,15156,53448
39053,polaciones,cantabria,36,20,32,86,230,404
39054,polanco,cantabria,2412,766,1108,4536,3640,12462
39055,potes,cantabria,350,154,258,820,1108,2690
39056,puente,cantabria,988,336,396,1958,2076,5754
39057,ramales,cantabria,918,302,516,1946,2428,6110
39058,rasines,cantabria,212,112,190,592,836,1942
39059,reinosa,cantabria,2060,898,1394,4518,8182,17052
39060,reocin,cantabria,2890,1140,1414,5492,5892,16828
39061,ribamontan,cantabria,1338,572,946,2836,3556,9248
39062,ribamontan,cantabria,816,326,422,1716,1814,5094
39063,rionansa,cantabria,172,58,146,448,1180,2004
39064,riotuerto,cantabria,462,180,316,962,1420,3340
39065,rozas,cantabria,58,16,40,144,264,522
39066,ruente,cantabria,282,140,150,680,892,2144
39067,ruesga,cantabria,122,74,132,424,908,1660
39068,ruiloba,cantabria,178,82,144,458,666,1528
39069,san,cantabria,770,262,406,1486,1818,4742
39070,san,cantabria,36,12,36,90,160,334
39071,san,cantabria,56,42,78,238,452,866
39072,san,cantabria,42,48,84,216,290,680
39073,santa,cantabria,4990,1934,2436,8764,9524,27648
39074,santa,cantabria,3332,1254,1684,6472,6150,18892
39075,santander,cantabria,46408,24954,34474,94494,146940,347270
39076,santillana,cantabria,1246,522,672,2664,3312,8416
39077,santiurde,cantabria,30,20,44,120,294,508
39078,santiurde,cantabria,504,150,324,1018,1480,3476
39079,santona,cantabria,3096,1520,2106,6250,8916,21888
39080,san,cantabria,976,486,698,2266,3544,7970
39081,saro,cantabria,128,56,86,270,476,1016
39082,selaya,cantabria,482,208,342,1074,1592,3698
39083,soba,cantabria,190,68,180,586,1126,2150
39084,solorzano,cantabria,302,118,194,682,924,2220
39085,suances,cantabria,2888,1188,1438,5938,6750,18202
39086,"tojos,",cantabria,54,34,70,214,376,748
39087,torrelavega,cantabria,14324,6834,9314,29004,43456,102932
39088,tresviso,cantabria,2,2,8,14,80,106
39089,tudanca,cantabria,22,12,34,80,164,312
39090,udias,cantabria,278,88,202,608,716,1892
39091,valdaliga,cantabria,518,234,324,1256,1974,4306
39092,valdeolea,cantabria,122,76,174,392,1004,1768
39093,valdeprado,cantabria,38,34,50,140,378,640
39094,valderredible,cantabria,156,106,170,482,962,1876
39095,val,cantabria,870,278,504,1718,2246,5616
39096,vega,cantabria,90,86,102,328,774,1380
39097,vega,cantabria,168,94,154,418,702,1536
39098,villacarriedo,cantabria,462,180,350,926,1442,3360
39099,villaescusa,cantabria,1254,608,638,2454,2952,7906
39100,villafufre,cantabria,246,134,176,624,858,2038
39101,valle,cantabria,42,24,12,172,252,502
39102,voto,cantabria,840,316,498,1958,2282,5894
40001,abades,segovia,276,100,150,514,676,1716
40002,adrada,segovia,10,6,2,32,32,82
40003,adrados,segovia,6,8,22,44,166,246
40004,aguilafuente,segovia,148,78,104,318,502,1150
40005,alconada,segovia,0,0,6,8,38,52
40006,aldealcorvo,segovia,2,0,0,14,20,36
40007,aldealengua,segovia,2,4,14,36,102,158
40008,aldealengua,segovia,16,4,4,28,68,120
40009,aldeanueva,segovia,4,0,8,20,56,88
40010,aldeanueva,segovia,6,10,22,32,146,216
40012,aldea,segovia,74,30,68,136,266,574
40013,aldeasona,segovia,0,4,14,24,92,134
40014,aldehorno,segovia,10,4,10,26,68,118
40015,aldehuela,segovia,2,0,0,18,30,50
40016,aldeonte,segovia,6,4,4,30,70,114
40017,anaya,segovia,30,14,26,62,104,236
40018,ane,segovia,4,0,8,30,90,132
40019,arahuetes,segovia,0,2,0,20,40,62
40020,arcones,segovia,18,16,20,98,206,358
40021,arevalillo,segovia,0,2,2,2,30,36
40022,armuna,segovia,28,34,42,104,274,482
40024,ayllon,segovia,358,194,188,590,858,2188
40025,barbolla,segovia,30,18,12,70,168,298
40026,basardilla,segovia,46,28,22,72,106,274
40028,bercial,segovia,10,8,20,46,126,210
40029,bercimuel,segovia,0,2,8,16,46,72
40030,bernardos,segovia,82,44,88,230,490,934
40031,bernuy,segovia,438,166,432,930,540,2506
40032,boceguillas,segovia,292,120,164,440,424,1440
40033,brieva,segovia,24,14,14,68,60,180
40034,caballar,segovia,6,12,14,28,90,150
40035,cabanas,segovia,82,16,22,130,150,400
40036,cabezuela,segovia,200,82,106,362,562,1312
40037,calabazas,segovia,0,0,0,14,36,50
40039,campo,segovia,80,26,52,138,224,520
40040,cantalejo,segovia,1214,486,774,1910,2724,7108
40041,cantimpalos,segovia,394,210,308,786,1144,2842
40043,carbonero,segovia,820,358,524,1444,1878,5024
40044,carrascal,segovia,18,14,34,58,150,274
40045,casla,segovia,28,28,36,90,136,318
40046,castillejo,segovia,16,22,24,58,110,230
40047,castro,segovia,0,2,8,24,62,96
40048,castrojimeno,segovia,0,0,0,16,46,62
40049,castroserna,segovia,0,2,2,16,44,64
40051,castroserracin,segovia,4,0,0,4,40,48
40052,cedillo,segovia,16,4,10,40,92,162
40053,cerezo,segovia,56,18,32,86,98,290
40054,cerezo,segovia,26,8,26,70,136,266
40055,cilleruelo,segovia,6,4,4,22,34,70
40056,cobos,segovia,2,4,4,8,38,56
40057,coca,segovia,424,214,342,990,1434,3404
40058,codorniz,segovia,38,30,50,144,354,616
40059,collado,segovia,4,20,38,60,112,234
40060,condado,segovia,10,6,14,34,96,160
40061,corral,segovia,8,4,8,32,102,154
40062,cubillo,segovia,4,18,4,36,84,146
40063,cuellar,segovia,2836,1264,1888,5384,7508,18880
40065,chane,segovia,148,102,200,538,556,1544
40068,domingo,segovia,10,6,0,12,34,62
40069,donhierro,segovia,14,10,12,32,82,150
40070,duruelo,segovia,34,20,30,80,176,340
40071,encinas,segovia,12,0,4,20,44,80
40072,encinillas,segovia,198,40,58,310,98,704
40073,escalona,segovia,106,58,76,206,480,926
40074,escarabajosa,segovia,58,42,44,136,278,558
40075,escobar,segovia,30,10,20,98,172,330
40076,"espinar,",segovia,3740,1426,1882,6658,6524,20230
40077,espirdo,segovia,724,206,354,1254,672,3210
40078,fresneda,segovia,22,6,32,72,202,334
40079,fresno,segovia,46,30,28,184,292,580
40080,fresno,segovia,18,6,16,42,80,162
40081,frumales,segovia,4,6,10,44,178,242
40082,fuente,segovia,8,4,12,24,150,198
40083,fuente,segovia,50,28,104,436,180,798
40084,fuente,segovia,0,6,14,26,44,90
40086,fuentepelayo,segovia,184,116,118,410,718,1546
40087,fuentepinel,segovia,0,0,18,28,88,134
40088,fuenterrebollo,segovia,92,34,62,168,318,674
40089,fuentesauco,segovia,32,10,42,116,248,448
40091,fuentesoto,segovia,12,6,14,34,134,200
40092,fuentiduena,segovia,26,16,24,40,160,266
40093,gallegos,segovia,20,12,18,44,94,188
40094,garcillan,segovia,202,46,138,334,320,1040
40095,gomezserracin,segovia,150,72,170,330,478,1200
40097,grajera,segovia,106,38,72,156,140,512
40099,honrubia,segovia,2,6,10,24,56,98
40100,hontalbilla,segovia,70,32,38,150,306,596
40101,hontanares,segovia,992,178,310,1350,498,3328
40103,"huertos,",segovia,62,6,28,124,126,346
40104,ituero,segovia,112,48,84,302,350,896
40105,juarros,segovia,2,2,8,30,58,100
40106,juarros,segovia,24,16,26,94,212,372
40107,labajos,segovia,14,12,14,60,104,204
40108,laguna,segovia,6,6,6,50,162,230
40109,languilla,segovia,18,2,16,44,88,168
40110,lastras,segovia,32,28,56,130,372,618
40111,lastras,segovia,18,2,12,28,68,128
40112,"lastrilla,",segovia,2082,684,1008,3044,2560,9378
40113,"losa,",segovia,200,40,72,338,408,1058
40115,maderuelo,segovia,22,8,10,36,128,204
40118,marazuela,segovia,24,4,8,24,46,106
40119,martin,segovia,64,34,80,166,178,522
40120,martin,segovia,106,24,50,228,206,614
40121,martin,segovia,32,24,28,140,300,524
40122,marugan,segovia,168,50,112,444,750,1524
40123,matabuena,segovia,32,18,48,134,188,420
40124,mata,segovia,56,38,40,146,244,524
40125,"matilla,",segovia,2,14,20,30,76,142
40126,melque,segovia,8,4,8,38,72,130
40127,membibre,segovia,2,2,4,24,54,86
40128,miguelanez,segovia,16,16,18,70,156,276
40129,montejo,segovia,30,6,28,64,194,322
40130,montejo,segovia,30,8,10,52,148,248
40131,monterrubio,segovia,12,4,8,34,54,112
40132,moral,segovia,2,0,12,10,54,78
40134,mozoncillo,segovia,156,148,222,514,770,1810
40135,munopedro,segovia,54,32,50,168,312,616
40136,munoveros,segovia,48,26,36,78,120,308
40138,nava,segovia,696,404,604,1594,2256,5554
40139,navafria,segovia,28,24,48,138,324,562
40140,navalilla,segovia,18,8,24,48,96,194
40141,navalmanzano,segovia,290,134,198,616,868,2106
40142,navares,segovia,6,6,14,20,60,106
40143,navares,segovia,18,6,8,32,120,184
40144,navares,segovia,0,2,2,10,36,50
40145,navas,segovia,314,164,262,612,1196,2548
40146,navas,segovia,138,40,64,240,268,750
40148,nieva,segovia,28,48,42,130,270,518
40149,olombrada,segovia,58,42,92,208,604,1004
40150,orejana,segovia,0,6,12,18,90,126
40151,ortigosa,segovia,10,18,10,22,46,106
40152,otero,segovia,314,122,170,628,696,1930
40154,pajarejos,segovia,6,0,2,10,30,48
40155,palazuelos,segovia,2798,940,898,4484,2830,11950
40156,pedraza,segovia,94,46,46,176,336,698
40157,pelayos,segovia,2,8,4,24,58,96
40158,perosillo,segovia,2,2,0,8,28,40
40159,pinarejos,segovia,48,26,36,104,168,382
40160,pinarnegrillo,segovia,6,4,12,42,128,192
40161,carabias,segovia,16,10,10,38,36,110
40162,pradena,segovia,120,62,96,228,430,936
40163,puebla,segovia,2,0,4,18,78,102
40164,rapariegos,segovia,16,14,34,116,212,392
40165,rebollo,segovia,2,4,8,30,104,148
40166,remondo,segovia,94,22,36,192,290,634
40168,riaguas,segovia,2,2,0,10,40,54
40170,riaza,segovia,720,290,452,1266,1560,4288
40171,ribota,segovia,6,2,2,16,60,86
40172,riofrio,segovia,4,0,6,12,32,54
40173,roda,segovia,96,30,62,176,142,506
40174,sacramenia,segovia,48,28,52,142,408,678
40176,samboal,segovia,96,32,110,232,450,920
40177,san,segovia,12,18,22,68,186,306
40178,san,segovia,14,10,20,30,92,166
40179,sanchonuno,segovia,318,166,258,596,714,2052
40180,sangarcia,segovia,24,26,62,120,326,558
40181,real,segovia,1576,664,1004,2978,4162,10384
40182,san,segovia,60,26,56,156,202,500
40183,san,segovia,28,10,16,74,140,268
40184,san,segovia,64,36,74,136,314,624
40185,santa,segovia,150,98,120,404,1008,1780
40186,santa,segovia,0,6,6,16,70,98
40188,santiuste,segovia,6,0,6,46,114,172
40189,santiuste,segovia,114,34,82,256,584,1070
40190,santo,segovia,12,2,6,40,44,104
40191,santo,segovia,28,34,34,104,260,460
40192,sauquillo,segovia,22,28,20,60,144,274
40193,sebulcor,segovia,50,44,68,128,200,490
40194,segovia,segovia,15196,8178,11682,25844,41876,102776
40195,sepulveda,segovia,216,140,214,494,908,1972
40196,sequera,segovia,16,2,10,28,32,88
40198,sotillo,segovia,8,0,6,10,38,62
40199,sotosalbos,segovia,42,20,16,74,128,280
40200,tabanera,segovia,12,6,6,38,48,110
40201,tolocirio,segovia,0,0,4,14,52,70
40202,torreadrada,segovia,4,2,8,16,70,100
40203,torrecaballeros,segovia,566,254,224,1104,850,2998
40204,torrecilla,segovia,26,10,42,98,186,362
40205,torreiglesias,segovia,30,24,40,128,290,512
40206,torre,segovia,32,14,40,82,192,360
40207,trescasas,segovia,476,194,166,798,578,2212
40208,turegano,segovia,246,124,238,492,930,2030
40210,uruenas,segovia,12,2,20,40,122,196
40211,valdeprados,segovia,4,2,20,22,72,120
40212,valdevacas,segovia,2,4,4,10,38,58
40213,valdevacas,segovia,6,6,8,36,106,162
40214,valseca,segovia,34,26,40,136,200,436
40215,valtiendas,segovia,6,6,16,26,100,154
40216,valverde,segovia,426,178,212,784,650,2250
40218,valle,segovia,8,6,14,26,94,148
40219,vallelado,segovia,160,108,168,386,630,1452
40220,valleruela,segovia,6,2,12,28,82,130
40221,valleruela,segovia,4,6,6,18,70,104
40222,veganzones,segovia,28,40,26,110,212,416
40223,vegas,segovia,64,26,64,222,308,684
40224,ventosilla,segovia,0,0,0,4,30,34
40225,villacastin,segovia,464,176,370,900,1120,3030
40228,villaverde,segovia,142,60,124,342,518,1186
40229,villaverde,segovia,0,0,0,8,34,42
40230,villeguillo,segovia,44,8,10,64,118,244
40231,yanguas,segovia,22,10,26,60,128,246
40233,zarzuela,segovia,114,54,74,310,448,1000
40234,zarzuela,segovia,92,58,60,198,404,812
40901,ortigosa,segovia,204,126,88,354,404,1176
40902,cozuelos,segovia,14,14,6,52,132,218
40903,marazoleja,segovia,16,8,4,56,108,192
40904,navas,segovia,128,48,60,218,430,884
40905,cuevas,segovia,16,10,10,58,170,264
40906,san,segovia,1150,736,756,1912,1728,6282
41001,aguadulce,sevilla,810,266,500,1176,1376,4128
41002,alanis,sevilla,470,242,374,910,1342,3338
41003,albaida,sevilla,1402,534,818,2092,1608,6454
41004,alcala,sevilla,30776,12778,15698,50756,44216,154224
41005,alcala,sevilla,5148,1690,2662,8198,6888,24586
41006,alcolea,sevilla,1186,468,726,2026,2160,6566
41007,"algaba,",sevilla,6908,2260,3476,11262,9604,33510
41008,algamitas,sevilla,400,198,296,664,934,2492
41009,almaden,sevilla,312,216,282,744,1118,2672
41010,almensilla,sevilla,2864,1046,1342,4756,3326,13334
41011,arahal,sevilla,7528,2918,4614,11484,12330,38874
41012,aznalcazar,sevilla,2038,754,1172,3060,2822,9846
41013,aznalcollar,sevilla,2246,1010,1410,3704,3826,12196
41014,badolatosa,sevilla,1110,518,768,1754,2002,6152
41015,benacazon,sevilla,3312,1124,1584,4904,3842,14766
41016,bollullos,sevilla,5002,1878,2040,7924,5666,22510
41017,bormujos,sevilla,10328,4490,4138,15830,11180,45966
41018,brenes,sevilla,4870,2112,2974,8082,7652,25690
41019,burguillos,sevilla,3214,1216,1790,4974,3502,14696
41020,cabezas,sevilla,5990,2944,3782,10190,9894,32800
41021,camas,sevilla,10326,3980,6592,18700,17876,57474
41022,"campana,",sevilla,1684,840,1168,3012,3560,10264
41023,cantillana,sevilla,4052,1776,2512,6588,6506,21434
41024,carmona,sevilla,10272,4880,6690,17862,20304,60008
41025,carrion,sevilla,906,326,520,1662,1812,5226
41026,casariche,sevilla,1824,808,1164,3120,3690,10606
41027,castilblanco,sevilla,1638,642,1162,3028,3872,10342
41028,castilleja,sevilla,1066,792,552,1786,1550,5746
41029,castilleja,sevilla,6206,2584,3838,10532,11192,34352
41030,castilleja,sevilla,166,92,158,324,474,1214
41031,castillo,sevilla,350,190,290,806,1392,3028
41032,cazalla,sevilla,1342,732,962,2458,3798,9292
41033,constantina,sevilla,1626,848,1352,3102,4544,11472
41034,coria,sevilla,12132,4822,7022,19922,18374,62272
41035,coripe,sevilla,326,164,224,646,1036,2396
41036,"coronil,",sevilla,1476,706,1056,2656,3488,9382
41037,"corrales,",sevilla,1372,612,936,2214,2802,7936
41038,dos,sevilla,56632,23140,30352,91106,79696,280926
41039,ecija,sevilla,14604,6336,9154,23184,26080,79358
41040,espartinas,sevilla,7686,2978,2914,11348,8182,33108
41041,estepa,sevilla,4586,2036,3094,7222,7882,24820
41042,fuentes,sevilla,2314,1068,1686,4226,5214,14508
41043,"garrobo,",sevilla,228,106,216,508,560,1618
41044,gelves,sevilla,3910,2002,2270,6692,6108,20982
41045,gerena,sevilla,3158,1116,1600,5348,4624,15846
41046,gilena,sevilla,1202,638,860,2100,2536,7336
41047,gines,sevilla,5112,2448,2868,8012,8676,27116
41048,guadalcanal,sevilla,696,358,592,1236,2164,5046
41049,guillena,sevilla,5920,2304,3132,9684,7180,28220
41050,herrera,sevilla,2356,1042,1576,3786,4386,13146
41051,huevar,sevilla,1210,570,812,2216,1920,6728
41052,lantejuela,sevilla,1476,706,986,2222,2330,7720
41053,lebrija,sevilla,10534,4512,6074,17258,17080,55458
41054,lora,sevilla,224,108,232,468,750,1782
41055,lora,sevilla,6670,2782,4060,10652,12406,36570
41056,"luisiana,",sevilla,1652,676,1098,2712,3124,9262
41057,"madrono,",sevilla,58,18,54,146,334,610
41058,mairena,sevilla,10122,3802,5342,16188,13122,48576
41059,mairena,sevilla,19350,7534,10050,30502,28376,95812
41060,marchena,sevilla,7632,2976,4296,11562,12332,38798
41061,marinaleda,sevilla,870,348,714,1442,1766,5140
41062,martin,sevilla,836,400,650,1526,1878,5290
41063,"molares,",sevilla,1428,608,888,2304,2064,7292
41064,montellano,sevilla,2552,1168,1626,4246,4486,14078
41065,moron,sevilla,9038,4114,5578,16268,19438,54436
41066,navas,sevilla,482,216,312,794,1238,3042
41067,olivares,sevilla,3454,1746,2180,5764,5864,19008
41068,osuna,sevilla,6346,2906,4112,9748,11616,34728
41069,palacios,sevilla,15950,6746,9260,23620,21952,77528
41070,palomares,sevilla,4302,1452,1484,6602,4712,18552
41071,paradas,sevilla,2372,1022,1480,3930,4818,13622
41072,pedrera,sevilla,1900,862,1138,3016,3328,10244
41073,"pedroso,",sevilla,552,328,400,1162,1708,4150
41074,penaflor,sevilla,1264,490,778,2132,2660,7324
41075,pilas,sevilla,5496,2400,3470,8916,8012,28294
41076,pruna,sevilla,740,436,612,1360,1914,5062
41077,puebla,sevilla,4030,1782,2378,6474,6970,21634
41078,puebla,sevilla,950,444,620,1614,2206,5834
41079,puebla,sevilla,4418,1870,2642,7392,7398,23720
41080,real,sevilla,446,246,372,824,1168,3056
41081,"rinconada,",sevilla,15518,7014,8972,26430,22730,80664
41082,roda,sevilla,1444,612,988,2422,2906,8372
41083,"ronquillo,",sevilla,442,194,230,922,1092,2880
41084,"rubio,",sevilla,1020,480,854,1904,2368,6626
41085,salteras,sevilla,2146,922,1186,3562,3388,11204
41086,san,sevilla,8820,3532,5416,15024,13432,46224
41087,sanlucar,sevilla,5358,2350,3238,9146,8640,28732
41088,san,sevilla,150,82,100,350,516,1198
41089,santiponce,sevilla,3284,1398,1734,5694,5188,17298
41090,"saucejo,",sevilla,1408,648,990,2342,3056,8444
41091,sevilla,sevilla,228004,106930,159050,400272,479226,1373482
41092,tocina,sevilla,3284,1378,2060,5680,6358,18760
41093,tomares,sevilla,10824,4414,4592,16262,15098,51190
41094,umbrete,sevilla,4310,1358,1842,6742,4538,18790
41095,utrera,sevilla,19536,8232,11792,32118,32880,104558
41096,valencina,sevilla,2722,1464,1638,4592,5754,16170
41097,villamanrique,sevilla,1872,692,968,2990,2788,9310
41098,villanueva,sevilla,2634,1188,1524,4320,4282,13948
41099,villanueva,sevilla,1684,738,1180,2808,3704,10114
41100,villanueva,sevilla,242,144,190,532,896,2004
41101,villaverde,sevilla,2928,1376,1830,4804,4642,15580
41102,viso,sevilla,8042,2952,4444,12088,11110,38636
41901,canada,sevilla,1302,468,782,2106,2178,6836
41902,isla,sevilla,2074,856,1320,3574,3746,11570
41903,cuervo,sevilla,3184,1286,2062,5564,5326,17422
41904,palmar,sevilla,760,416,544,1304,1588,4612
42001,abejar,soria,120,48,98,196,304,766
42003,adradas,soria,4,16,8,18,82,128
42004,agreda,soria,1034,422,644,1614,2456,6170
42006,alconaba,soria,44,10,34,138,176,402
42007,alcubilla,soria,4,8,10,50,140,212
42008,alcubilla,soria,10,8,4,42,54,118
42009,aldealafuente,soria,12,6,18,38,98,172
42010,aldealices,soria,6,0,0,12,22,40
42011,aldealpozo,soria,2,2,4,8,20,36
42012,aldealsenor,soria,6,0,4,10,36,56
42013,aldehuela,soria,6,2,2,14,36,60
42014,"aldehuelas,",soria,4,4,8,16,90,122
42015,alentisque,soria,0,2,6,2,38,48
42016,aliud,soria,0,4,4,14,20,42
42017,almajano,soria,44,36,34,106,138,358
42018,almaluez,soria,8,0,22,54,166,250
42019,almarza,soria,138,68,96,330,624,1256
42020,almazan,soria,1784,746,1174,2966,4268,10938
42021,almazul,soria,0,2,0,24,96,122
42022,almenar,soria,42,24,32,110,230,438
42023,alpanseque,soria,0,4,2,16,80,102
42024,arancon,soria,0,2,4,36,110,152
42025,arcos,soria,416,184,300,802,1386,3088
42026,arenillas,soria,8,2,2,34,38,84
42027,arevalo,soria,0,12,8,30,90,140
42028,ausejo,soria,50,8,18,74,84,234
42029,baraona,soria,8,6,14,66,152,246
42030,barca,soria,20,8,10,42,134,214
42031,barcones,soria,6,0,0,20,24,50
42032,bayubas,soria,14,6,20,56,196,292
42033,bayubas,soria,12,6,14,12,76,120
42034,beraton,soria,2,0,6,34,40,82
42035,berlanga,soria,176,120,144,400,828,1668
42036,blacos,soria,0,2,4,10,60,76
42037,bliecos,soria,2,2,2,10,36,52
42038,borjabad,soria,0,0,2,14,44,60
42039,borobia,soria,32,36,38,94,256,456
42041,buberos,soria,0,2,2,16,36,56
42042,buitrago,soria,26,12,16,46,48,148
42043,burgo,soria,1430,760,984,2948,4212,10334
42044,cabrejas,soria,2,6,6,22,70,106
42045,cabrejas,soria,64,24,46,150,316,600
42046,calatanazor,soria,4,0,6,18,58,86
42048,caltojar,soria,0,6,6,18,72,102
42049,candilichera,soria,0,6,14,32,156,208
42050,canamaque,soria,2,0,0,16,36,54
42051,carabantes,soria,4,2,8,10,20,44
42052,caracena,soria,0,0,2,6,20,28
42053,carrascosa,soria,0,0,0,6,30,36
42054,carrascosa,soria,0,0,4,12,22,38
42055,casarejos,soria,14,12,18,68,180,292
42056,castilfrio,soria,2,10,6,14,36,68
42057,castilruiz,soria,30,6,20,88,168,312
42058,castillejo,soria,14,0,18,36,122,190
42059,centenera,soria,2,0,2,8,30,42
42060,cerbon,soria,4,0,2,12,42,60
42061,cidones,soria,58,22,24,174,350,628
42062,cigudosa,soria,0,0,2,14,14,30
42063,cihuela,soria,2,0,6,16,54,78
42064,ciria,soria,2,4,12,20,104,142
42065,cirujales,soria,0,2,0,8,30,40
42068,coscurita,soria,0,0,12,32,92,136
42069,covaleda,soria,268,188,298,778,1626,3158
42070,cubilla,soria,0,0,2,18,28,48
42071,cubo,soria,22,6,20,66,212,326
42073,cueva,soria,4,0,0,42,92,138
42075,devanos,soria,4,0,4,34,102,144
42076,deza,soria,4,22,36,50,220,332
42078,duruelo,soria,134,116,200,504,1106,2060
42079,escobosa,soria,2,0,0,6,32,40
42080,espeja,soria,18,20,32,56,178,304
42081,espejon,soria,34,22,22,70,118,266
42082,estepa,soria,0,6,0,4,16,26
42083,frechilla,soria,0,0,4,10,28,42
42084,fresno,soria,0,0,2,14,22,38
42085,fuentearmegil,soria,2,4,14,52,228,300
42086,fuentecambron,soria,0,4,6,8,46,64
42087,fuentecantos,soria,12,12,14,40,52,130
42088,fuentelmonge,soria,2,12,12,18,78,122
42089,fuentelsaz,soria,10,8,12,22,78,130
42090,fuentepinilla,soria,2,0,10,26,118,156
42092,fuentes,soria,8,0,6,22,68,104
42093,fuentestrun,soria,6,0,14,26,58,104
42094,garray,soria,290,82,142,538,520,1572
42095,golmayo,soria,1478,494,508,2134,1514,6128
42096,gomara,soria,46,34,46,168,286,580
42097,gormaz,soria,4,0,2,24,22,52
42098,herrera,soria,0,0,2,2,18,22
42100,hinojosa,soria,0,0,0,8,42,50
42103,langa,soria,172,88,138,376,660,1434
42105,liceras,soria,8,2,10,18,60,98
42106,"losilla,",soria,2,2,4,4,14,26
42107,magana,soria,12,0,10,40,64,126
42108,majan,soria,0,2,0,2,14,18
42110,matalebreras,soria,12,6,16,40,90,164
42111,matamala,soria,22,24,20,138,308,512
42113,medinaceli,soria,180,76,100,366,612,1334
42115,mino,soria,6,8,18,44,80,156
42116,mino,soria,4,2,6,24,44,80
42117,molinos,soria,36,16,30,84,152,318
42118,momblona,soria,0,0,0,8,28,36
42119,monteagudo,soria,52,20,22,84,178,356
42120,montejo,soria,26,16,24,58,162,286
42121,montenegro,soria,6,4,6,22,52,90
42123,moron,soria,30,26,32,78,236,402
42124,muriel,soria,8,0,2,38,60,108
42125,muriel,soria,8,16,6,44,76,150
42127,nafria,soria,2,6,6,12,46,72
42128,narros,soria,12,4,22,34,70,142
42129,navaleno,soria,128,90,174,332,744,1468
42130,nepas,soria,0,2,0,26,72,100
42131,nolay,soria,4,4,6,4,78,96
42132,noviercas,soria,26,24,24,58,198,330
42134,olvega,soria,1124,584,792,2548,2604,7652
42135,oncala,soria,0,4,12,26,80,122
42139,pinilla,soria,0,0,2,6,28,36
42140,portillo,soria,0,0,2,2,20,24
42141,poveda,soria,20,2,22,50,124,218
42142,pozalmuro,soria,4,12,8,18,50,92
42144,quintana,soria,136,52,74,272,488,1022
42145,quintanas,soria,18,6,26,58,148,256
42148,quinoneria,soria,0,0,0,8,12,20
42149,"rabanos,",soria,102,70,84,288,416,960
42151,rebollar,soria,4,10,10,12,36,72
42152,recuerda,soria,8,10,2,36,72,128
42153,rello,soria,0,2,0,10,26,38
42154,renieblas,soria,8,6,24,70,112,220
42155,retortillo,soria,6,2,6,40,208,262
42156,reznos,soria,0,0,2,6,36,44
42157,riba,soria,0,2,2,0,14,18
42158,rioseco,soria,34,10,20,58,132,254
42159,rollamienta,soria,2,2,12,14,64,94
42160,"royo,",soria,24,20,50,122,288,504
42161,salduero,soria,12,18,20,62,184,296
42162,san,soria,740,438,612,1468,2624,5882
42163,san,soria,10,4,6,36,62,118
42164,san,soria,464,232,366,1118,1720,3900
42165,san,soria,186,84,156,364,448,1238
42166,santa,soria,6,10,4,18,74,112
42167,santa,soria,30,22,26,102,300,480
42168,santa,soria,12,4,12,44,154,226
42171,seron,soria,22,14,14,60,140,250
42172,soliedra,soria,8,4,2,12,40,66
42173,soria,soria,14008,6230,8980,22226,29864,81308
42174,sotillo,soria,16,20,36,92,190,354
42175,suellacabras,soria,4,4,10,24,24,66
42176,tajahuerce,soria,0,0,0,10,36,46
42177,tajueco,soria,2,6,6,26,74,114
42178,talveila,soria,2,8,10,40,148,208
42181,tardelcuende,soria,86,28,52,192,490,848
42182,taroda,soria,2,10,0,20,62,94
42183,tejado,soria,2,8,10,40,134,194
42184,torlengua,soria,0,4,6,26,54,90
42185,torreblacos,soria,0,2,0,6,44,52
42187,torrubia,soria,0,6,8,38,60,112
42188,trevago,soria,4,4,6,22,58,94
42189,ucero,soria,32,6,22,58,70,188
42190,vadillo,soria,0,12,14,30,112,168
42191,valdeavellano,soria,40,10,28,112,248,438
42192,valdegena,soria,0,4,6,10,54,74
42193,valdelagua,soria,4,4,0,2,16,26
42194,valdemaluque,soria,10,8,24,48,184,274
42195,valdenebro,soria,14,8,18,34,116,190
42196,valdeprado,soria,0,0,4,2,10,16
42197,valderrodilla,soria,2,2,8,28,84,124
42198,valtajeros,soria,4,0,2,6,26,38
42200,velamazan,soria,2,0,6,32,94,134
42201,velilla,soria,0,0,4,8,42,54
42202,velilla,soria,0,0,0,4,26,30
42204,viana,soria,0,2,8,26,62,98
42205,villaciervos,soria,2,2,12,46,110,172
42206,villanueva,soria,0,0,0,2,14,16
42207,villar,soria,4,16,12,12,56,100
42208,villar,soria,0,0,0,22,38,60
42209,villar,soria,18,4,30,68,196,316
42211,villares,soria,10,4,8,50,82,154
42212,villasayas,soria,14,2,2,40,62,120
42213,villaseca,soria,4,0,2,10,32,48
42215,vinuesa,soria,186,86,178,452,764,1666
42216,vizmanos,soria,8,0,4,20,28,60
42217,vozmediano,soria,2,8,0,12,44,66
42218,yanguas,soria,38,14,16,62,82,212
42219,yelo,soria,0,0,2,18,54,74
43001,aiguamurcia,tarragona,280,126,180,574,770,1930
43002,albinyana,tarragona,882,412,544,1696,1822,5356
43003,"albiol,",tarragona,268,68,88,368,284,1076
43004,alcanar,tarragona,3278,1308,1964,5920,7272,19742
43005,alcover,tarragona,1986,780,1104,3266,3532,10668
43006,aldover,tarragona,248,118,116,566,746,1794
43007,"aleixar,",tarragona,350,152,218,612,628,1960
43008,alfara,tarragona,84,46,50,248,298,726
43009,alforja,tarragona,628,238,444,1244,1500,4054
43010,alio,tarragona,220,44,86,308,354,1012
43011,almoster,tarragona,448,254,262,758,954,2676
43012,altafulla,tarragona,2276,850,948,3516,4028,11618
43013,ametlla,tarragona,2234,1142,1284,4186,5848,14694
43014,amposta,tarragona,8450,3748,5020,13700,14328,45246
43015,arboli,tarragona,24,2,28,106,98,258
43016,"arboç,",tarragona,2418,970,1242,3494,3366,11490
43017,"argentera,",tarragona,12,10,30,74,132,258
43018,arnes,tarragona,112,44,80,218,472,926
43019,asco,tarragona,478,178,368,856,1338,3218
43020,banyeres,tarragona,1244,564,560,2240,2072,6680
43021,barberà,tarragona,126,74,72,330,358,960
43022,batea,tarragona,606,204,384,944,1624,3762
43023,bellmunt,tarragona,68,42,54,158,266,588
43024,bellvei,tarragona,894,420,526,1558,1420,4818
43025,benifallet,tarragona,128,84,156,346,734,1448
43026,benissanet,tarragona,334,166,252,766,866,2384
43027,bisbal,tarragona,36,26,30,98,224,414
43028,bisbal,tarragona,1394,594,878,2668,2832,8366
43029,blancafort,tarragona,92,50,96,230,318,786
43030,bonastre,tarragona,294,92,136,484,518,1524
43031,borges,tarragona,840,406,424,1376,1466,4512
43032,bot,tarragona,122,74,80,278,550,1104
43033,botarell,tarragona,430,194,228,768,720,2340
43034,bràfim,tarragona,256,94,114,446,484,1394
43035,cabaces,tarragona,60,42,72,148,280,602
43036,cabra,tarragona,420,246,302,866,816,2650
43037,calafell,tarragona,10572,4614,6608,19468,21872,63134
43038,cambrils,tarragona,13936,5672,7072,23526,23166,73372
43039,capafonts,tarragona,8,12,24,70,98,212
43040,capçanes,tarragona,122,48,68,266,348,852
43041,caseres,tarragona,48,26,54,94,258,480
43042,castellvell,tarragona,1108,578,568,1702,2026,5982
43043,"catllar,",tarragona,2180,718,966,3430,3136,10430
43044,"senia,",tarragona,1782,892,1026,3426,4110,11236
43045,colldejou,tarragona,42,20,20,106,134,322
43046,conesa,tarragona,26,10,30,58,102,226
43047,constanti,tarragona,3056,1100,1634,4324,3728,13842
43048,corbera,tarragona,254,146,204,548,880,2032
43049,cornudella,tarragona,256,130,230,676,774,2066
43050,creixell,tarragona,1444,516,806,2388,3184,8338
43051,cunit,tarragona,5272,2314,3140,9642,11132,31500
43052,xerta,tarragona,294,168,218,588,1038,2306
43053,duesaigues,tarragona,48,22,60,116,200,446
43054,espluga,tarragona,1182,518,862,2238,2900,7700
43055,falset,tarragona,986,470,504,1672,2118,5750
43056,"fatarella,",tarragona,174,100,116,346,976,1712
43057,"febro,",tarragona,0,0,6,26,40,72
43058,"figuera,",tarragona,22,14,22,68,120,246
43059,figuerola,tarragona,92,72,64,202,262,692
43060,flix,tarragona,812,426,628,1666,3114,6646
43061,fores,tarragona,2,6,2,26,44,80
43062,freginals,tarragona,114,62,70,214,390,850
43063,"galera,",tarragona,202,74,120,438,600,1434
43064,gandesa,tarragona,1116,448,650,1854,2252,6320
43065,garcia,tarragona,158,68,86,310,458,1080
43066,"garidells,",tarragona,50,20,52,112,174,408
43067,ginestar,tarragona,180,96,120,422,782,1600
43068,godall,tarragona,144,68,148,310,572,1242
43069,gratallops,tarragona,44,30,36,138,216,464
43070,"guiamets,",tarragona,42,16,42,132,280,512
43071,horta,tarragona,288,140,186,678,1022,2314
43072,"lloar,",tarragona,26,10,18,48,98,200
43073,llorac,tarragona,24,6,24,58,92,204
43074,llorenç,tarragona,822,382,490,1310,1840,4844
43075,margalef,tarragona,6,4,26,56,124,216
43076,marçà,tarragona,182,86,124,352,454,1198
43077,mas,tarragona,112,74,68,332,506,1092
43078,masdenverge,tarragona,342,162,230,676,888,2298
43079,masllorenç,tarragona,150,86,98,372,428,1134
43080,"maso,",tarragona,100,34,38,192,212,576
43081,maspujols,tarragona,362,132,182,656,454,1786
43082,"masroig,",tarragona,128,76,88,304,364,960
43083,"milà,",tarragona,72,26,38,108,150,394
43084,miravet,tarragona,198,90,108,388,582,1366
43085,"molar,",tarragona,76,36,64,166,274,616
43086,montblanc,tarragona,2602,1148,1504,4538,5286,15078
43088,montbrio,tarragona,1352,352,682,2168,1720,6274
43089,montferri,tarragona,170,68,124,290,294,946
43090,"montmell,",tarragona,672,256,400,1192,1312,3832
43091,mont-ral,tarragona,56,12,36,118,148,370
43092,mont-roig,tarragona,4948,1916,2938,9148,9420,28370
43093,mora,tarragona,2014,828,1274,3208,4154,11478
43094,mora,tarragona,1136,544,712,1830,2396,6618
43095,"morell,",tarragona,1540,596,912,2660,1994,7702
43096,morera,tarragona,34,14,36,98,106,288
43097,nou,tarragona,280,128,80,390,344,1222
43098,nulles,tarragona,252,70,102,374,316,1114
43099,palma,tarragona,58,26,84,150,352,670
43100,"pallaresos,",tarragona,2164,1058,816,3328,2670,10036
43101,passanant,tarragona,16,14,10,74,210,324
43102,pauls,tarragona,154,44,80,274,534,1086
43103,perafort,tarragona,546,242,280,960,610,2638
43104,"perello,",tarragona,960,350,520,1710,2326,5866
43105,"piles,",tarragona,100,24,34,128,174,460
43106,pinell,tarragona,266,174,190,474,846,1950
43107,pira,tarragona,180,78,98,314,328,998
43108,pla,tarragona,822,356,568,1324,1712,4782
43109,pobla,tarragona,1990,608,1082,3018,1556,8254
43110,pobla,tarragona,88,42,86,164,308,688
43111,pobla,tarragona,1174,476,704,2210,2150,6714
43112,poboleda,tarragona,88,24,58,218,278,666
43113,pont,tarragona,124,54,100,264,454,996
43114,porrera,tarragona,96,28,120,222,368,834
43115,pradell,tarragona,40,26,26,82,182,356
43116,prades,tarragona,168,86,126,416,546,1342
43117,prat,tarragona,54,42,30,98,152,376
43118,pratdip,tarragona,206,104,134,440,642,1526
43119,puigpelat,tarragona,492,214,214,822,674,2416
43120,querol,tarragona,132,46,124,366,522,1190
43121,rasquera,tarragona,206,78,132,400,776,1592
43122,renau,tarragona,86,18,14,128,70,316
43123,reus,tarragona,42136,18334,24906,64384,70162,219922
43124,"riba,",tarragona,152,76,130,278,500,1136
43125,riba-roja,tarragona,244,100,176,566,1166,2252
43126,riera,tarragona,826,302,268,1222,994,3612
43127,riudecanyes,tarragona,500,214,312,902,790,2718
43128,riudecols,tarragona,400,160,332,764,840,2496
43129,riudoms,tarragona,2582,1106,1556,4058,4606,13908
43130,rocafort,tarragona,78,24,44,136,210,492
43131,roda,tarragona,2736,1156,1572,4954,5636,16054
43132,rodonyà,tarragona,152,84,124,270,414,1044
43133,roquetes,tarragona,3072,1298,1792,5166,5420,16748
43134,"rourell,",tarragona,138,56,80,272,260,806
43135,salomo,tarragona,194,78,106,284,398,1060
43136,"ràpita,",tarragona,4766,2376,3134,9368,11960,31604
43137,sant,tarragona,1114,410,472,1868,1748,5612
43138,santa,tarragona,1308,594,764,2162,2810,7638
43139,santa,tarragona,974,558,566,1510,2038,5646
43140,santa,tarragona,1494,540,678,2296,2350,7358
43141,pontils,tarragona,44,0,26,72,104,246
43142,sarral,tarragona,546,244,334,896,1156,3176
43143,savallà,tarragona,2,6,16,20,52,96
43144,"secuita,",tarragona,726,220,394,1234,1082,3656
43145,selva,tarragona,2168,1010,1312,3384,3804,11678
43146,senan,tarragona,10,6,20,20,36,92
43147,solivella,tarragona,174,96,128,324,532,1254
43148,tarragona,tarragona,49988,23216,33806,83260,91766,282036
43149,tivenys,tarragona,230,132,196,506,810,1874
43150,tivissa,tarragona,426,182,336,946,1358,3248
43151,torre,tarragona,36,16,12,70,104,238
43152,torre,tarragona,184,92,104,356,524,1260
43153,torredembarra,tarragona,5974,2720,3696,10658,12858,35906
43154,torroja,tarragona,26,10,20,82,136,274
43155,tortosa,tarragona,12746,5718,8008,20404,24150,71026
43156,ulldecona,tarragona,2266,964,1436,3974,4556,13196
43157,ulldemolins,tarragona,72,42,50,208,456,828
43158,vallclara,tarragona,22,16,16,54,70,178
43159,vallfogona,tarragona,6,10,16,42,122,196
43160,vallmoll,tarragona,766,274,388,1234,1212,3874
43161,valls,tarragona,9094,4094,5434,14782,16766,50170
43162,vandellòs,tarragona,2718,978,1434,4530,4504,14164
43163,"vendrell,",tarragona,14620,6108,8504,24568,27252,81052
43164,vespella,tarragona,168,50,70,330,390,1008
43165,vilabella,tarragona,214,106,132,376,622,1450
43166,vilallonga,tarragona,1138,280,536,1748,1222,4924
43167,vilanova,tarragona,196,102,78,378,468,1222
43168,vilanova,tarragona,22,22,10,76,90,220
43169,vilaplana,tarragona,158,50,122,314,476,1120
43170,vila-rodona,tarragona,534,152,290,860,922,2758
43171,vila-seca,tarragona,9708,3500,5272,16648,12994,48122
43172,vilaverd,tarragona,124,86,74,340,316,940
43173,vilella,tarragona,40,22,22,78,98,260
43174,vilella,tarragona,56,36,40,120,160,412
43175,vilalba,tarragona,162,70,112,322,562,1228
43176,vimbodi,tarragona,230,124,114,470,848,1786
43177,vinebre,tarragona,132,54,86,236,344,852
43178,vinyols,tarragona,944,346,578,1546,1436,4850
43901,deltebre,tarragona,3796,1718,2362,7184,8822,23882
43902,sant,tarragona,1116,568,714,2070,2874,7342
43903,camarles,tarragona,1040,502,732,1990,2592,6856
43904,"aldea,",tarragona,1544,652,1156,2780,2976,9108
43905,salou,tarragona,10984,4576,7238,21054,17032,60884
43906,"ampolla,",tarragona,984,452,720,2158,3070,7384
43907,"canonja,",tarragona,2264,956,1364,3680,3608,11872
44001,ababuj,teruel,18,8,14,46,64,150
44002,abejuela,teruel,6,10,4,34,60,114
44003,aguaton,teruel,2,0,0,10,22,34
44004,aguaviva,teruel,176,80,118,262,458,1094
44005,aguilar,teruel,20,12,38,30,62,162
44006,alacon,teruel,20,10,36,62,288,416
44007,alba,teruel,34,12,24,90,214,374
44008,albalate,teruel,548,244,450,912,1714,3868
44009,albarracin,teruel,258,162,246,530,814,2010
44010,albentosa,teruel,108,54,52,190,190,594
44011,alcaine,teruel,4,0,4,18,50,76
44012,alcala,teruel,80,50,72,188,366,756
44013,alcaniz,teruel,6260,2506,3092,9648,10868,32374
44014,alcorisa,teruel,1150,470,614,1718,2500,6452
44016,alfambra,teruel,102,42,98,232,498,972
44017,aliaga,teruel,74,28,78,178,334,692
44018,almohaja,teruel,0,0,0,6,18,24
44019,alobras,teruel,2,12,16,36,72,138
44020,alpenes,teruel,4,0,8,8,32,52
44021,allepuz,teruel,28,18,18,52,132,248
44022,alloza,teruel,134,56,88,254,570,1102
44023,allueva,teruel,10,4,0,20,26,60
44024,anadon,teruel,0,4,6,24,34,68
44025,andorra,teruel,2242,1034,1358,4028,5806,14468
44026,arcos,teruel,34,12,30,56,88,220
44027,arens,teruel,24,22,30,74,242,392
44028,argente,teruel,46,16,40,76,224,402
44029,arino,teruel,144,74,128,354,594,1294
44031,azaila,teruel,16,2,24,34,110,186
44032,badenas,teruel,6,2,2,20,18,48
44033,baguena,teruel,54,26,42,152,324,598
44034,banon,teruel,34,12,20,94,150,310
44035,barrachina,teruel,22,4,24,62,118,230
44036,bea,teruel,6,6,0,8,32,52
44037,beceite,teruel,134,74,110,280,526,1124
44038,belmonte,teruel,30,26,22,36,156,270
44039,bello,teruel,30,24,34,94,244,426
44040,berge,teruel,56,40,32,138,170,436
44041,bezas,teruel,12,12,18,40,54,136
44042,blancas,teruel,24,14,32,40,158,268
44043,blesa,teruel,0,0,12,28,112,152
44044,bordon,teruel,36,16,12,66,96,226
44045,bronchales,teruel,120,48,88,310,358,924
44046,buena,teruel,14,8,6,26,58,112
44047,burbaguena,teruel,96,52,84,152,320,704
44048,cabra,teruel,6,4,22,24,76,132
44049,calaceite,teruel,252,90,160,448,968,1918
44050,calamocha,teruel,1560,728,1038,2534,3172,9032
44051,calanda,teruel,1188,508,800,2060,2828,7384
44052,calomarde,teruel,2,4,10,42,90,148
44053,camanas,teruel,34,16,22,86,98,256
44054,camarena,teruel,50,4,32,88,110,284
44055,camarillas,teruel,26,18,28,74,94,240
44056,caminreal,teruel,178,80,112,332,532,1234
44059,cantavieja,teruel,224,94,154,416,546,1434
44060,canada,teruel,4,2,8,18,46,78
44061,canada,teruel,4,22,10,44,80,160
44062,canada,teruel,4,2,0,18,52,76
44063,canizar,teruel,40,12,30,52,86,220
44064,cascante,teruel,4,4,4,36,82,130
44065,castejon,teruel,4,8,6,36,78,132
44066,castel,teruel,18,6,14,32,98,168
44067,castelnou,teruel,22,10,16,56,100,204
44068,castelseras,teruel,246,104,128,412,714,1604
44070,"castellar,",teruel,0,4,18,18,72,112
44071,castellote,teruel,126,48,126,312,710,1322
44074,cedrillas,teruel,210,96,144,366,474,1290
44075,celadas,teruel,30,58,96,140,334,658
44076,cella,teruel,782,350,552,1454,2190,5328
44077,"cerollera,",teruel,10,12,14,48,70,154
44080,"codonera,",teruel,90,36,66,166,284,642
44082,corbalan,teruel,40,18,18,70,90,236
44084,cortes,teruel,10,2,16,30,72,130
44085,cosa,teruel,6,6,12,36,64,124
44086,cretas,teruel,176,50,92,310,504,1132
44087,crivillen,teruel,18,12,16,44,92,182
44088,"cuba,",teruel,24,2,12,20,42,100
44089,cubla,teruel,10,6,26,30,44,116
44090,cucalon,teruel,12,4,8,54,80,158
44092,"cuervo,",teruel,14,6,14,50,106,190
44093,cuevas,teruel,38,16,28,46,102,230
44094,cuevas,teruel,20,8,22,82,140,272
44096,ejulve,teruel,32,18,64,68,162,344
44097,escorihuela,teruel,24,2,36,74,146,282
44099,escucha,teruel,254,96,200,440,564,1554
44100,estercuel,teruel,38,14,72,98,184,406
44101,ferreruela,teruel,18,8,6,58,62,152
44102,fonfria,teruel,8,0,8,22,32,70
44103,formiche,teruel,32,22,46,70,150,320
44105,fornoles,teruel,6,2,18,32,86,144
44106,fortanete,teruel,70,44,66,98,154,432
44107,foz-calanda,teruel,90,36,72,152,216,566
44108,"fresneda,",teruel,108,70,86,242,406,912
44109,frias,teruel,28,16,16,62,102,224
44110,fuenferrada,teruel,0,0,0,8,62,70
44111,fuentes,teruel,10,2,26,34,100,172
44112,fuentes,teruel,98,32,74,188,474,866
44113,fuentes,teruel,78,12,38,94,88,310
44114,fuentespalda,teruel,54,28,68,142,294,586
44115,galve,teruel,42,22,36,66,122,288
44116,gargallo,teruel,12,16,12,50,84,174
44117,gea,teruel,80,38,100,240,474,932
44118,"ginebrosa,",teruel,58,24,32,100,176,390
44119,griegos,teruel,20,10,42,56,158,286
44120,guadalaviar,teruel,46,30,70,108,232,486
44121,gudar,teruel,28,8,16,50,46,148
44122,hijar,teruel,560,290,364,808,1468,3490
44123,hinojosa,teruel,4,4,14,48,128,198
44124,hoz,teruel,20,6,14,46,88,174
44125,huesa,teruel,0,2,4,22,86,114
44126,iglesuela,teruel,90,56,66,204,336,752
44127,jabaloyas,teruel,2,4,10,42,66,124
44128,jarque,teruel,8,4,6,26,80,124
44129,jatiel,teruel,4,8,14,22,50,98
44130,jorcas,teruel,8,4,8,20,38,78
44131,josa,teruel,2,0,8,24,36,70
44132,lagueruela,teruel,14,4,14,42,64,138
44133,lanzuela,teruel,6,0,8,8,26,48
44135,libros,teruel,8,6,26,54,110,204
44136,lidon,teruel,0,4,6,34,68,112
44137,linares,teruel,56,16,50,154,192,468
44138,loscos,teruel,6,12,22,42,144,226
44141,lledo,teruel,28,6,34,64,182,314
44142,maicas,teruel,0,0,6,12,52,70
44143,manzanera,teruel,146,76,152,296,402,1072
44144,martin,teruel,88,64,76,156,354,738
44145,mas,teruel,298,128,244,628,1150,2448
44146,mata,teruel,86,42,86,160,176,550
44147,mazaleon,teruel,122,68,114,202,456,962
44148,mezquita,teruel,18,4,24,34,82,162
44149,mirambel,teruel,32,2,20,70,90,214
44150,miravete,teruel,6,6,12,8,32,64
44151,molinos,teruel,44,22,52,92,246,456
44152,monforte,teruel,6,2,18,38,86,150
44153,monreal,teruel,1046,352,560,1378,1744,5080
44154,monroyo,teruel,100,22,86,174,244,626
44155,montalban,teruel,280,136,244,564,1106,2330
44156,monteagudo,teruel,2,6,8,16,54,86
44157,monterde,teruel,2,2,10,30,72,116
44158,mora,teruel,550,202,448,862,1168,3230
44159,moscardon,teruel,20,12,4,38,48,122
44160,mosqueruela,teruel,174,70,110,254,478,1086
44161,muniesa,teruel,164,84,112,230,556,1146
44163,noguera,teruel,34,14,28,66,118,260
44164,nogueras,teruel,2,8,6,12,36,64
44165,nogueruelas,teruel,60,12,48,96,172,388
44167,obon,teruel,0,0,6,12,44,62
44168,odon,teruel,32,20,38,88,218,396
44169,ojos,teruel,88,38,54,156,320,656
44171,olba,teruel,124,28,26,222,186,586
44172,oliete,teruel,74,40,68,176,384,742
44173,"olmos,",teruel,22,20,24,58,112,236
44174,orihuela,teruel,88,48,124,216,440,916
44175,orrios,teruel,2,6,30,62,142,242
44176,palomar,teruel,20,10,32,94,164,320
44177,pancrudo,teruel,24,10,12,66,114,226
44178,parras,teruel,2,4,2,38,64,110
44179,penarroya,teruel,146,66,108,214,382,916
44180,peracense,teruel,16,10,8,40,72,146
44181,peralejos,teruel,24,14,18,40,82,178
44182,perales,teruel,82,28,94,112,232,548
44183,pitarque,teruel,2,8,14,16,82,122
44184,plou,teruel,0,0,2,28,62,92
44185,"pobo,",teruel,20,4,12,60,100,196
44187,"portellada,",teruel,68,6,40,122,246,482
44189,pozondon,teruel,0,0,6,44,58,108
44190,pozuel,teruel,8,0,24,22,80,134
44191,puebla,teruel,282,112,202,472,794,1862
44192,puebla,teruel,116,66,110,276,364,932
44193,puertomingalvo,teruel,52,8,32,82,106,280
44194,rafales,teruel,56,6,18,78,150,308
44195,rillo,teruel,14,8,22,66,90,200
44196,riodeva,teruel,14,12,20,64,132,242
44197,rodenas,teruel,6,2,14,26,74,122
44198,royuela,teruel,46,42,40,108,214,450
44199,rubiales,teruel,4,10,6,22,44,86
44200,rubielos,teruel,0,0,4,10,38,52
44201,rubielos,teruel,168,84,168,332,490,1242
44203,salcedillo,teruel,0,0,4,8,14,26
44204,saldon,teruel,8,2,2,10,30,52
44205,samper,teruel,128,120,130,374,710,1462
44206,san,teruel,20,12,28,72,142,274
44207,san,teruel,14,8,22,42,184,270
44208,santa,teruel,0,0,2,8,38,48
44209,santa,teruel,246,130,250,482,928,2036
44210,sarrion,teruel,514,164,282,670,800,2430
44211,segura,teruel,8,4,2,22,60,96
44212,seno,teruel,2,2,6,22,44,76
44213,singra,teruel,2,14,20,34,80,150
44215,terriente,teruel,44,14,48,92,218,416
44216,teruel,teruel,12882,5498,7796,20714,26040,72930
44217,toril,teruel,0,6,12,12,38,68
44218,tormon,teruel,0,0,2,22,38,62
44219,tornos,teruel,26,16,24,88,206,360
44220,torralba,teruel,26,26,34,76,130,292
44221,torrecilla,teruel,92,40,104,180,460,876
44222,torrecilla,teruel,8,4,16,48,158,234
44223,torre,teruel,6,8,16,46,88,164
44224,torre,teruel,2,2,6,6,24,40
44225,torre,teruel,16,8,20,48,148,240
44226,torrelacarcel,teruel,16,8,14,70,154,262
44227,torre,teruel,10,14,12,36,88,160
44228,torremocha,teruel,16,20,14,58,98,206
44229,torres,teruel,60,32,42,96,152,382
44230,torrevelilla,teruel,50,16,30,84,182,362
44231,torrijas,teruel,10,4,6,28,24,72
44232,torrijo,teruel,152,46,92,246,464,1000
44234,tramacastiel,teruel,2,6,8,24,76,116
44235,tramacastilla,teruel,30,16,24,60,124,254
44236,tronchon,teruel,6,6,8,28,72,120
44237,urrea,teruel,100,52,66,226,434,878
44238,utrillas,teruel,996,448,680,1792,2286,6202
44239,valacloche,teruel,6,2,8,14,34,64
44240,valbona,teruel,30,22,28,106,198,384
44241,valdealgorfa,teruel,144,56,86,272,604,1162
44243,valdecuenca,teruel,6,2,4,22,22,56
44244,valdelinares,teruel,10,18,22,42,58,150
44245,valdeltormo,teruel,92,28,44,172,274,610
44246,valderrobres,teruel,860,380,516,1518,1774,5048
44247,valjunquera,teruel,80,50,62,150,314,656
44249,"vallecillo,",teruel,2,4,4,20,44,74
44250,veguillas,teruel,0,2,4,18,24,48
44251,villafranca,teruel,62,44,64,152,268,590
44252,villahermosa,teruel,24,8,6,62,86,186
44256,villanueva,teruel,6,8,8,28,46,96
44257,villar,teruel,18,22,30,80,172,322
44258,villar,teruel,4,4,10,28,62,108
44260,villarluengo,teruel,36,12,24,106,152,330
44261,villarquemado,teruel,214,94,170,492,772,1742
44262,villarroya,teruel,46,22,30,94,136,328
44263,villastar,teruel,230,68,126,366,306,1096
44264,villel,teruel,108,36,94,204,234,676
44265,vinaceite,teruel,24,28,46,82,180,360
44266,visiedo,teruel,26,16,20,38,162,262
44267,vivel,teruel,4,4,6,34,78,126
44268,"zoma,",teruel,0,2,8,10,34,54
45001,ajofrin,toledo,870,298,418,1382,1760,4728
45002,alameda,toledo,1752,602,1058,2630,2430,8472
45003,albarreal,toledo,240,98,148,478,554,1518
45004,alcabon,toledo,280,108,166,416,560,1530
45005,alcanizo,toledo,46,38,32,142,294,552
45006,alcaudete,toledo,432,224,332,782,1588,3358
45007,alcolea,toledo,230,106,206,446,674,1662
45008,aldea,toledo,38,26,52,108,190,414
45009,aldeanueva,toledo,66,50,64,198,550,928
45010,aldeanueva,toledo,76,22,30,184,502,814
45011,almendral,toledo,78,52,44,122,396,692
45012,almonacid,toledo,258,110,284,590,716,1958
45013,almorox,toledo,822,312,486,1438,1910,4968
45014,anover,toledo,1832,836,1122,3210,3750,10750
45015,arcicollar,toledo,370,162,226,680,730,2168
45016,arges,toledo,3236,1246,1368,4926,3354,14130
45017,azutan,toledo,60,16,52,116,336,580
45018,barcience,toledo,538,190,182,834,414,2158
45019,bargas,toledo,4398,1556,2494,7350,6466,22264
45020,belvis,toledo,302,170,270,696,1422,2860
45021,borox,toledo,1568,656,1112,2884,2370,8590
45022,buenaventura,toledo,40,28,60,160,464,752
45023,burguillos,toledo,1722,598,766,2726,1676,7488
45024,burujon,toledo,480,196,274,744,964,2658
45025,cabanas,toledo,806,372,522,1364,1206,4270
45026,cabanas,toledo,90,26,66,184,246,612
45027,cabezamesada,toledo,58,18,54,196,364,690
45028,calera,toledo,1696,622,958,2924,3336,9536
45029,caleruela,toledo,24,22,46,84,226,402
45030,calzada,toledo,68,68,136,266,498,1036
45031,camarena,toledo,1832,660,1006,3032,2738,9268
45032,camarenilla,toledo,154,66,104,348,538,1210
45033,campillo,toledo,62,16,68,170,334,650
45034,camunas,toledo,612,234,362,926,1364,3498
45035,cardiel,toledo,82,46,66,216,374,784
45036,carmena,toledo,200,118,208,426,746,1698
45037,carpio,toledo,458,256,360,940,1726,3740
45038,carranque,toledo,2332,878,890,4176,2562,10838
45039,carriches,toledo,90,24,58,146,222,540
45040,casar,toledo,714,320,482,1290,1440,4246
45041,casarrubios,toledo,2836,1070,1592,5092,3758,14348
45042,casasbuenas,toledo,30,10,42,94,210,386
45043,castillo,toledo,178,96,238,398,964,1874
45045,cazalegas,toledo,752,322,420,1304,1448,4246
45046,cebolla,toledo,1172,534,664,1798,2308,6476
45047,cedillo,toledo,1966,620,958,3234,2074,8852
45048,"cerralbos,",toledo,88,48,76,174,480,866
45049,cervera,toledo,136,68,80,338,372,994
45050,ciruelos,toledo,236,110,168,478,412,1404
45051,cobeja,toledo,1104,448,728,1680,1374,5334
45052,cobisa,toledo,1688,1118,786,2780,2648,9020
45053,consuegra,toledo,3280,1474,1996,5376,7466,19592
45054,corral,toledo,1782,814,1102,3010,3950,10658
45055,cuerva,toledo,362,194,246,718,1040,2560
45056,chozas,toledo,2330,936,1064,3350,2044,9724
45057,chueca,toledo,66,42,50,114,226,498
45058,domingo,toledo,82,48,46,200,416,792
45059,dosbarrios,toledo,792,344,494,1270,1572,4472
45060,erustes,toledo,82,34,24,146,174,460
45061,escalona,toledo,1168,552,754,2270,2870,7614
45062,escalonilla,toledo,538,210,298,868,1080,2994
45063,espinoso,toledo,68,26,56,172,514,836
45064,esquivias,toledo,2282,940,1264,3690,3510,11686
45065,"estrella,",toledo,24,26,28,68,390,536
45066,fuensalida,toledo,5436,1902,2928,7550,7064,24880
45067,galvez,toledo,930,468,538,1664,2406,6006
45068,garciotum,toledo,82,16,42,98,192,430
45069,gerindote,toledo,1066,426,732,1610,1742,5576
45070,guadamur,toledo,548,254,364,984,1408,3558
45071,"guardia,",toledo,624,344,430,1160,1792,4350
45072,"herencias,",toledo,146,124,160,418,738,1586
45073,herreruela,toledo,36,50,56,148,380,670
45074,hinojosa,toledo,68,56,68,174,410,776
45075,hontanar,toledo,24,16,38,82,144,304
45076,hormigos,toledo,308,122,184,630,744,1988
45077,huecas,toledo,306,100,186,532,630,1754
45078,huerta,toledo,640,260,330,1008,1322,3560
45079,iglesuela,toledo,130,36,56,264,416,902
45080,illan,toledo,0,0,0,2,2,4
45081,illescas,toledo,15170,4994,6992,23392,13678,64226
45082,lagartera,toledo,288,136,204,624,1402,2654
45083,layos,toledo,390,116,128,608,574,1816
45084,lillo,toledo,704,330,490,1410,2080,5014
45085,lominchar,toledo,1190,494,648,1932,1370,5634
45086,lucillos,toledo,198,70,128,374,512,1282
45087,madridejos,toledo,3174,1516,2134,5694,7624,20142
45088,magan,toledo,1892,668,928,2952,1762,8202
45089,malpica,toledo,408,236,340,904,1500,3388
45090,manzaneque,toledo,90,38,92,228,372,820
45091,maqueda,toledo,106,64,86,252,498,1006
45092,marjaliza,toledo,46,30,50,120,288,534
45093,marrupe,toledo,24,12,18,62,208,324
45094,mascaraque,toledo,108,28,78,270,372,856
45095,"mata,",toledo,332,160,216,396,726,1830
45096,mazarambroz,toledo,414,198,282,670,1006,2570
45097,mejorada,toledo,408,236,220,818,1096,2778
45098,menasalbas,toledo,618,378,500,1194,2252,4942
45099,mentrida,toledo,2852,960,1282,4604,3110,12808
45100,mesegar,toledo,46,30,36,110,182,404
45101,miguel,toledo,1392,794,1118,2650,3462,9416
45102,mocejon,toledo,2108,744,1108,3226,3160,10346
45103,mohedas,toledo,96,60,58,190,420,824
45104,montearagon,toledo,174,64,88,340,508,1174
45105,montesclaros,toledo,46,42,42,208,406,744
45106,mora,toledo,3530,1498,2142,5578,7260,20008
45107,nambroca,toledo,2466,816,1048,3524,2770,10624
45108,nava,toledo,86,68,112,244,532,1042
45109,navahermosa,toledo,1000,542,704,1984,2974,7204
45110,navalcan,toledo,400,240,332,902,1860,3734
45111,navalmoralejo,toledo,0,0,0,14,96,110
45112,"navalmorales,",toledo,512,312,476,1060,1954,4314
45113,"navalucillos,",toledo,308,222,322,858,2078,3788
45114,navamorcuende,toledo,104,50,84,262,700,1200
45115,noblejas,toledo,1700,610,796,2284,2480,7870
45116,noez,toledo,330,124,268,586,692,2000
45117,nombela,toledo,242,130,178,514,730,1794
45118,noves,toledo,1464,632,706,2218,1946,6966
45119,numancia,toledo,2326,994,1356,3760,2846,11282
45120,nuno,toledo,28,24,12,100,176,340
45121,ocana,toledo,6784,2326,3764,9796,6880,29550
45122,olias,toledo,3796,1292,1976,5856,4932,17852
45123,ontigola,toledo,2044,726,1034,4004,2204,10012
45124,orgaz,toledo,852,364,542,1462,1986,5206
45125,oropesa,toledo,630,308,454,1456,2276,5124
45126,otero,toledo,90,64,86,348,286,874
45127,palomeque,toledo,422,150,226,924,674,2396
45128,pantoja,toledo,1466,608,728,2290,2160,7252
45129,paredes,toledo,12,8,12,72,156,260
45130,parrillas,toledo,60,36,56,160,370,682
45131,pelahustan,toledo,82,32,40,166,348,668
45132,pepino,toledo,1176,598,552,1996,2218,6540
45133,polan,toledo,1400,674,892,2324,2598,7888
45134,portillo,toledo,876,394,498,1304,1616,4688
45135,puebla,toledo,1334,856,1088,2604,4040,9922
45136,puebla,toledo,2746,1384,1878,4602,5470,16080
45137,"pueblanueva,",toledo,728,320,490,1214,1528,4280
45138,puente,toledo,264,152,194,612,1088,2310
45139,puerto,toledo,10,6,10,44,226,296
45140,pulgar,toledo,532,260,350,986,1098,3226
45141,quero,toledo,250,126,214,522,936,2048
45142,quintanar,toledo,4120,1788,2440,6430,7544,22322
45143,quismondo,toledo,700,258,380,1070,1244,3652
45144,real,toledo,210,108,178,450,1002,1948
45145,recas,toledo,2240,814,1282,3318,2712,10366
45146,retamoso,toledo,12,2,12,56,138,220
45147,rielves,toledo,310,122,170,634,504,1740
45148,robledo,toledo,10,10,36,88,360,504
45149,"romeral,",toledo,94,74,68,256,606,1098
45150,san,toledo,198,92,94,332,490,1206
45151,san,toledo,212,94,140,384,734,1564
45152,san,toledo,116,52,124,240,676,1208
45153,san,toledo,400,166,302,910,1592,3370
45154,san,toledo,780,266,326,1490,1360,4222
45155,santa,toledo,48,30,56,116,436,686
45156,santa,toledo,1256,556,840,2300,3420,8372
45157,santa,toledo,1460,624,842,2616,2532,8074
45158,santa,toledo,1234,486,802,2042,2552,7116
45159,sartajada,toledo,16,4,8,62,108,198
45160,segurilla,toledo,448,208,274,870,994,2794
45161,sesena,toledo,15040,4836,6744,23280,10256,60156
45162,sevilleja,toledo,54,42,98,234,816,1244
45163,sonseca,toledo,4228,1722,2426,6428,7788,22592
45164,sotillo,toledo,18,16,28,86,220,368
45165,talavera,toledo,30352,13890,18138,49462,58434,170276
45166,tembleque,toledo,544,294,414,1086,1722,4060
45167,"toboso,",toledo,426,210,332,930,1578,3476
45168,toledo,toledo,31636,13274,19940,52296,55416,172562
45169,torralba,toledo,38,22,42,110,174,386
45170,torrecilla,toledo,28,20,40,100,254,442
45171,torre,toledo,532,316,370,1190,1466,3874
45172,torrico,toledo,138,74,106,342,754,1414
45173,torrijos,toledo,5576,2300,3144,8494,8642,28156
45174,totanes,toledo,90,50,94,188,332,754
45175,turleque,toledo,180,74,136,348,642,1380
45176,ugena,toledo,2384,1118,1086,4352,2792,11732
45177,urda,toledo,702,376,518,1302,2062,4960
45179,valdeverdeja,toledo,112,70,86,278,586,1132
45180,valmojado,toledo,2114,700,1056,3226,2512,9608
45181,velada,toledo,994,432,564,1758,2088,5836
45182,ventas,toledo,296,104,230,572,1078,2280
45183,ventas,toledo,1834,758,892,3036,1832,8352
45184,ventas,toledo,34,24,38,124,240,460
45185,villacanas,toledo,3122,1528,1946,5494,7046,19136
45186,villa,toledo,966,528,808,1900,2870,7072
45187,villafranca,toledo,1386,740,1074,2650,4004,9854
45188,villaluenga,toledo,1666,648,858,2600,2592,8364
45189,villamiel,toledo,410,164,236,740,612,2162
45190,villaminaya,toledo,122,50,88,282,470,1012
45191,villamuelas,toledo,142,98,106,326,566,1238
45192,villanueva,toledo,786,484,538,1556,2566,5930
45193,villanueva,toledo,174,86,118,338,644,1360
45194,villarejo,toledo,4,4,18,50,82,158
45195,villarrubia,toledo,780,320,568,1334,2104,5106
45196,villaseca,toledo,696,280,456,1144,1224,3800
45197,villasequilla,toledo,916,348,618,1530,1862,5274
45198,villatobas,toledo,1074,344,642,1652,2002,5714
45199,viso,toledo,2830,848,1390,4908,2454,12430
45200,"yebenes,",toledo,1918,970,1368,3130,4084,11470
45201,yeles,toledo,2982,1080,1556,4878,3108,13604
45202,yepes,toledo,2158,778,1184,3520,3602,11242
45203,yuncler,toledo,2300,674,1374,3304,2446,10098
45204,yunclillos,toledo,246,136,188,432,628,1630
45205,yuncos,toledo,5902,2350,3080,9274,5706,26312
45901,santo,toledo,414,178,276,840,756,2464
46001,ademuz,valencia/valencia,298,154,182,520,852,2006
46002,ador,valencia/valencia,472,256,402,1092,1262,3484
46003,atzeneta,valencia/valencia,352,194,190,760,858,2354
46004,agullent,valencia/valencia,718,366,512,1410,1826,4832
46005,alaquàs,valencia/valencia,9996,4810,6386,18406,20788,60386
46006,albaida,valencia/valencia,2068,970,1346,3648,4390,12422
46007,albal,valencia/valencia,6258,2960,3566,12014,9516,34314
46008,albalat,valencia/valencia,1240,448,688,2106,2442,6924
46009,albalat,valencia/valencia,1540,560,844,2688,2890,8522
46010,albalat,valencia/valencia,506,188,266,1092,1030,3082
46011,alberic,valencia/valencia,4128,1668,2430,6500,7152,21878
46012,alborache,valencia/valencia,414,262,354,954,996,2980
46013,alboraia/alboraya,valencia/valencia,9290,4336,5074,17150,16668,52518
46014,albuixech,valencia/valencia,1456,600,876,2744,3172,8848
46015,alcàsser,valencia/valencia,4028,1468,2360,7098,6470,21424
46016,alcàntera,valencia/valencia,458,224,290,830,1038,2840
46017,alzira,valencia/valencia,16778,7486,10802,28290,31376,94732
46018,alcublas,valencia/valencia,112,86,150,334,698,1380
46019,"alcudia,",valencia/valencia,4602,1966,2624,7496,8062,24750
46020,alcudia,valencia/valencia,1804,852,1160,3320,3680,10816
46021,aldaia,valencia/valencia,12818,5318,7892,22406,19426,67860
46022,alfafar,valencia/valencia,7450,3418,4926,14110,14280,44184
46023,alfauir,valencia/valencia,130,84,86,298,378,976
46024,alfara,valencia/valencia,196,92,102,410,430,1230
46025,alfara,valencia/valencia,1200,1068,700,2154,2016,7138
46026,alfarb,valencia/valencia,612,244,320,1072,1140,3388
46027,alfarrasi,valencia/valencia,362,176,194,748,868,2348
46028,algar,valencia/valencia,148,70,94,328,444,1084
46029,algemesi,valencia/valencia,10770,4486,5922,16512,18142,55832
46030,algimia,valencia/valencia,292,200,176,668,860,2196
46031,alginet,valencia/valencia,5366,2146,3210,9094,9532,29348
46032,almàssera,valencia/valencia,2568,1102,1582,5032,5124,15408
46033,almiserà,valencia/valencia,68,30,68,170,236,572
46034,almoines,valencia/valencia,1066,360,578,1770,1536,5310
46035,almussafes,valencia/valencia,3316,1206,1810,5938,5758,18028
46036,alpuente,valencia/valencia,156,80,136,354,674,1400
46037,alqueria,valencia/valencia,540,208,340,858,1136,3082
46038,andilla,valencia/valencia,18,24,72,176,354,644
46039,anna,valencia/valencia,666,356,502,1422,2280,5226
46040,antella,valencia/valencia,286,108,210,614,1032,2250
46041,aras,valencia/valencia,106,54,70,198,356,784
46042,aielo,valencia/valencia,1508,804,914,2940,3008,9174
46043,aielo,valencia/valencia,34,18,20,84,172,328
46044,ayora,valencia/valencia,1592,734,990,2872,4350,10538
46045,barxeta,valencia/valencia,488,178,318,930,1246,3160
46046,barx,valencia/valencia,334,154,228,860,1418,2994
46047,belgida,valencia/valencia,182,116,116,356,512,1282
46048,bellreguard,valencia/valencia,1654,746,1028,3110,3334,9872
46049,bellus,valencia/valencia,64,60,54,208,224,610
46050,benageber,valencia/valencia,6,20,44,86,184,340
46051,benaguasil,valencia/valencia,4202,1782,3204,7626,8004,24818
46052,benavites,valencia/valencia,176,88,146,376,536,1322
46053,beneixida,valencia/valencia,172,84,172,360,506,1294
46054,benetusser,valencia/valencia,5334,2420,3994,10016,10870,32634
46055,beniarjo,valencia/valencia,700,320,456,1166,1204,3846
46056,beniatjar,valencia/valencia,32,32,34,114,208,420
46057,benicolet,valencia/valencia,194,58,78,298,578,1206
46058,benifairo,valencia/valencia,864,230,468,1478,1582,4622
46059,benifairo,valencia/valencia,424,246,312,846,1312,3140
46060,benifaio,valencia/valencia,3940,1772,2440,7126,8882,24160
46061,benifla,valencia/valencia,186,110,112,346,252,1006
46062,benigànim,valencia/valencia,1716,906,1240,3498,4238,11598
46063,benimodo,valencia/valencia,818,300,498,1510,1510,4636
46064,benimuslem,valencia/valencia,210,96,126,408,490,1330
46065,beniparrell,valencia/valencia,672,318,418,1410,1360,4178
46066,benirredrà,valencia/valencia,426,232,330,712,1416,3116
46067,benissano,valencia/valencia,774,398,544,1514,1620,4850
46068,benissoda,valencia/valencia,162,58,94,342,318,974
46069,benissuera,valencia/valencia,38,24,42,102,170,376
46070,betera,valencia/valencia,11056,4652,5118,17948,16418,55192
46071,bicorp,valencia/valencia,112,66,110,288,540,1116
46072,bocairent,valencia/valencia,1204,468,736,2368,3582,8358
46073,bolbaite,valencia/valencia,354,170,280,716,1132,2652
46074,bonrepòs,valencia/valencia,1698,550,832,2842,2152,8074
46075,bufali,valencia/valencia,40,18,32,82,138,310
46076,bugarra,valencia/valencia,156,102,158,412,738,1566
46077,bunol,valencia/valencia,3394,1410,1870,5688,7196,19558
46078,burjassot,valencia/valencia,13332,7196,10646,25116,25824,82114
46079,calles,valencia/valencia,90,38,96,230,440,894
46080,camporrobles,valencia/valencia,302,152,240,686,988,2368
46081,canals,valencia/valencia,4356,2024,2860,8092,9710,27042
46082,canet,valencia/valencia,2972,862,1410,5310,4864,15418
46083,carcaixent,valencia/valencia,7522,3274,4892,12776,14198,42662
46084,càrcer,valencia/valencia,594,238,420,974,1404,3630
46085,carlet,valencia/valencia,6420,2552,3260,9998,10546,32776
46086,carricola,valencia/valencia,16,14,18,58,90,196
46087,casas,valencia/valencia,34,22,16,72,134,278
46088,casas,valencia/valencia,40,22,22,70,180,334
46089,casinos,valencia/valencia,1008,470,678,1726,2328,6210
46090,castello,valencia/valencia,790,360,492,1450,1614,4706
46091,castellonet,valencia/valencia,34,12,42,72,136,296
46092,castielfabib,valencia/valencia,64,34,56,152,268,574
46093,catadau,valencia/valencia,970,420,636,1820,2162,6008
46094,catarroja,valencia/valencia,11796,4496,6172,20302,17414,60180
46095,caudete,valencia/valencia,196,106,140,388,612,1442
46096,cerdà,valencia/valencia,132,50,88,262,200,732
46097,cofrentes,valencia/valencia,268,148,248,630,954,2248
46098,corbera,valencia/valencia,1116,454,648,1846,2284,6348
46099,cortes,valencia/valencia,84,74,170,322,874,1524
46100,cotes,valencia/valencia,78,30,62,192,260,622
46101,quart,valencia/valencia,336,136,180,592,842,2086
46102,quart,valencia/valencia,8368,3516,6280,15416,18964,52544
46103,quartell,valencia/valencia,512,188,320,990,1424,3434
46104,quatretonda,valencia/valencia,600,214,474,1178,1956,4422
46105,cullera,valencia/valencia,7144,3720,5066,14472,17850,48252
46106,chelva,valencia/valencia,416,180,364,918,1526,3404
46107,chella,valencia/valencia,684,352,448,1456,1974,4914
46108,chera,valencia/valencia,88,52,104,224,512,980
46109,cheste,valencia/valencia,2932,1462,2010,5638,6094,18136
46110,xirivella,valencia/valencia,10806,5288,8074,19374,20064,63606
46111,chiva,valencia/valencia,6178,2756,3598,11692,10480,34704
46112,chulilla,valencia/valencia,122,70,136,416,598,1342
46113,daimus,valencia/valencia,998,486,704,2146,2724,7058
46114,domeno,valencia/valencia,186,106,152,436,500,1380
46115,dos,valencia/valencia,78,32,56,194,314,674
46116,"eliana,",valencia/valencia,7026,3156,3702,11486,13960,39330
46117,emperador,valencia/valencia,274,86,152,608,284,1404
46118,enguera,valencia/valencia,1340,696,1026,2776,3892,9730
46119,"enova,",valencia/valencia,254,110,190,492,796,1842
46120,estivella,valencia/valencia,480,222,268,976,1324,3270
46121,estubeny,valencia/valencia,16,10,18,64,112,220
46122,faura,valencia/valencia,1224,466,778,2386,2500,7354
46123,favara,valencia/valencia,826,394,540,1788,1854,5402
46124,fontanars,valencia/valencia,278,130,200,512,776,1896
46125,fortaleny,valencia/valencia,328,114,176,592,808,2018
46126,foios,valencia/valencia,2966,916,1428,5284,4922,15516
46127,font,valencia/valencia,1320,572,770,2436,2826,7924
46128,font,valencia/valencia,630,282,414,1160,1608,4094
46129,fuenterrobles,valencia/valencia,200,82,156,428,526,1392
46130,gavarda,valencia/valencia,352,126,232,592,770,2072
46131,gandia,valencia/valencia,27700,13116,17718,48512,52956,160002
46132,"genoves,",valencia/valencia,956,460,606,1620,2012,5654
46133,gestalgar,valencia/valencia,116,66,64,314,566,1126
46134,gilet,valencia/valencia,1538,520,716,2748,2250,7772
46135,godella,valencia/valencia,4910,2288,2736,7422,9562,26918
46136,godelleta,valencia/valencia,1522,618,732,2944,2616,8432
46137,granja,valencia/valencia,60,38,62,178,254,592
46138,guadassequies,valencia/valencia,156,74,90,320,294,934
46139,guadassuar,valencia/valencia,2038,848,1230,3426,4388,11930
46140,guardamar,valencia/valencia,220,96,108,384,390,1198
46141,higueruelas,valencia/valencia,108,68,122,258,512,1068
46142,jalance,valencia/valencia,108,72,148,368,916,1612
46143,xeraco,valencia/valencia,1882,950,1230,3716,4282,12060
46144,jarafuel,valencia/valencia,138,94,102,354,820,1508
46145,xàtiva,valencia/valencia,9748,4862,6800,18454,20776,60640
46146,xeresa,valencia/valencia,888,348,500,1426,1516,4678
46147,lliria,valencia/valencia,8634,3898,5260,15696,17102,50590
46148,loriguilla,valencia/valencia,844,288,476,1580,1184,4372
46149,losa,valencia/valencia,152,88,100,302,412,1054
46150,llutxent,valencia/valencia,764,396,494,1384,1630,4668
46151,llocnou,valencia/valencia,300,102,212,540,690,1844
46152,llocnou,valencia/valencia,30,12,32,78,92,244
46153,llocnou,valencia/valencia,152,82,116,324,494,1168
46154,llanera,valencia/valencia,392,138,224,640,742,2136
46155,llauri,valencia/valencia,328,146,228,742,1028,2472
46156,llombai,valencia/valencia,934,398,568,1708,1918,5526
46157,llosa,valencia/valencia,1142,550,826,2232,2756,7506
46158,macastre,valencia/valencia,420,196,382,836,1136,2970
46159,manises,valencia/valencia,10970,5184,7318,20398,20640,64510
46160,manuel,valencia/valencia,798,412,560,1444,1820,5034
46161,marines,valencia/valencia,642,256,392,1264,1310,3864
46162,massalaves,valencia/valencia,680,212,398,1192,1096,3578
46163,massalfassar,valencia/valencia,1016,298,552,1940,1490,5296
46164,massamagrell,valencia/valencia,5994,2648,3612,11334,10838,34426
46165,massanassa,valencia/valencia,3790,1378,2276,6702,6508,20654
46166,meliana,valencia/valencia,3816,1528,2108,7030,7482,21964
46167,millares,valencia/valencia,50,44,62,156,376,688
46168,miramar,valencia/valencia,958,440,552,1918,2174,6042
46169,mislata,valencia/valencia,14822,6968,10884,28318,31270,92262
46170,moixent/mogente,valencia/valencia,1284,686,922,2504,3346,8742
46171,montcada/moncada,valencia/valencia,6798,4650,4442,12780,15292,43962
46172,montserrat,valencia/valencia,3682,1346,2044,7048,5180,19300
46173,montaverner,valencia/valencia,510,226,362,980,1204,3282
46174,montesa,valencia/valencia,292,154,246,658,914,2264
46175,montitxelvo/montichelvo,valencia/valencia,146,98,120,356,452,1172
46176,montroi/montroy,valencia/valencia,1126,434,788,2306,2274,6928
46177,museros,valencia/valencia,2438,990,1438,4862,4018,13746
46178,nàquera/naquera,valencia/valencia,3042,1180,1830,6284,4496,16832
46179,navarres,valencia/valencia,1042,440,650,1716,2280,6128
46180,novetle,valencia/valencia,300,122,150,546,592,1710
46181,oliva,valencia/valencia,8768,3882,5138,15294,19458,52540
46182,olocau,valencia/valencia,734,274,398,1738,1674,4818
46183,"olleria,",valencia/valencia,2884,1284,1848,5458,5944,17418
46184,ontinyent,valencia/valencia,11916,5922,7808,21366,25626,72638
46185,otos,valencia/valencia,134,50,88,230,376,878
46186,paiporta,valencia/valencia,10544,4294,5944,19562,15406,55750
46187,palma,valencia/valencia,476,232,420,1010,1510,3648
46188,palmera,valencia/valencia,414,164,206,680,596,2060
46189,"palomar,",valencia/valencia,190,70,130,374,446,1210
46190,paterna,valencia/valencia,31474,11350,15022,49670,41500,149016
46191,pedralba,valencia/valencia,902,384,634,1946,2476,6342
46192,petres,valencia/valencia,416,164,222,728,764,2294
46193,picanya,valencia/valencia,4114,1832,2458,7144,8184,23732
46194,picassent,valencia/valencia,8356,3362,4704,14696,14164,45282
46195,piles,valencia/valencia,1092,514,640,2094,2074,6414
46196,pinet,valencia/valencia,22,6,34,84,154,300
46197,polinyà,valencia/valencia,886,344,488,1622,1760,5100
46198,potries,valencia/valencia,282,122,254,702,856,2216
46199,pobla,valencia/valencia,3168,1174,1918,6228,5828,18316
46200,pobla,valencia/valencia,728,314,490,1364,1992,4888
46201,puebla,valencia/valencia,2,2,2,24,72,102
46202,pobla,valencia/valencia,11350,4356,5500,19096,14362,54664
46203,pobla,valencia/valencia,1468,572,926,2900,3268,9134
46204,puig,valencia/valencia,3160,1298,1740,5762,6714,18674
46205,puçol,valencia/valencia,7830,3236,4282,13664,13550,42562
46206,quesa,valencia/valencia,150,86,136,448,536,1356
46207,rafelbunyol,valencia/valencia,3704,1342,2120,6630,5582,19378
46208,rafelcofer,valencia/valencia,382,200,322,702,1160,2766
46209,rafelguaraf,valencia/valencia,700,346,492,1422,1724,4684
46210,rafol,valencia/valencia,180,48,62,280,344,914
46211,real,valencia/valencia,1010,416,632,1612,1708,5378
46212,real,valencia/valencia,752,368,538,1458,1766,4882
46213,requena,valencia/valencia,6830,3274,4288,11934,15442,41768
46214,riba-roja,valencia/valencia,9056,4262,5042,15602,14508,48470
46215,riola,valencia/valencia,620,258,302,1176,1204,3560
46216,rocafort,valencia/valencia,3198,1434,1466,4740,4678,15516
46217,rotglà,valencia/valencia,338,210,224,688,880,2340
46218,ròtova,valencia/valencia,390,150,212,776,1012,2540
46219,rugat,valencia/valencia,26,26,34,98,162,346
46220,sagunt/sagunto,valencia/valencia,24308,10788,14964,43508,49944,143512
46221,salem,valencia/valencia,90,78,76,216,336,796
46222,sant,valencia/valencia,180,72,116,354,326,1048
46223,sedavi,valencia/valencia,3588,1622,2316,6878,7424,21828
46224,segart,valencia/valencia,14,28,36,100,162,340
46225,sellent,valencia/valencia,66,50,104,208,346,774
46226,sempere,valencia/valencia,0,2,4,10,42,58
46227,senyera,valencia/valencia,388,164,262,676,756,2246
46228,serra,valencia/valencia,1234,556,814,2320,2552,7476
46229,siete,valencia/valencia,298,182,252,782,1112,2626
46230,silla,valencia/valencia,6980,2858,4334,12832,13198,40202
46231,simat,valencia/valencia,896,464,710,1900,2692,6662
46232,sinarcas,valencia/valencia,308,172,270,602,954,2306
46233,sollana,valencia/valencia,1530,682,1144,3120,3602,10078
46234,sot,valencia/valencia,102,52,98,262,356,870
46235,sueca,valencia/valencia,9078,4270,6098,17620,20618,57684
46236,sumacàrcer,valencia/valencia,222,136,212,568,942,2080
46237,tavernes,valencia/valencia,3028,1440,2122,5984,6626,19200
46238,tavernes,valencia/valencia,5702,2600,3654,10450,12922,35328
46239,teresa,valencia/valencia,74,54,76,228,760,1192
46240,terrateig,valencia/valencia,54,60,50,180,236,580
46241,titaguas,valencia/valencia,114,38,92,248,500,992
46242,torrebaja,valencia/valencia,86,54,64,192,392,788
46243,torrella,valencia/valencia,50,12,28,86,124,300
46244,torrent,valencia/valencia,34258,14766,20550,55962,53376,178912
46245,torres,valencia/valencia,192,94,150,508,560,1504
46246,tous,valencia/valencia,438,150,276,846,1008,2718
46247,tuejar,valencia/valencia,250,134,254,596,1240,2474
46248,turis,valencia/valencia,2648,1032,1454,4936,4938,15008
46249,utiel,valencia/valencia,3530,1654,2194,6656,9288,23322
46250,valencia,valencia/valencia,251208,128212,208474,477826,582960,1648680
46251,vallada,valencia/valencia,854,410,708,1720,2500,6192
46252,vallanca,valencia/valencia,22,12,26,64,138,262
46253,valles,valencia/valencia,52,24,18,116,86,296
46254,venta,valencia/valencia,224,170,166,584,1202,2346
46255,vilallonga/villalonga,valencia/valencia,1520,678,1096,2934,3254,9482
46256,vilamarxant,valencia/valencia,3976,1536,2480,7126,7210,22328
46257,castello,valencia/valencia,2154,1158,1536,3960,5052,13860
46258,villar,valencia/valencia,1138,558,766,2136,2944,7542
46259,villargordo,valencia/valencia,164,82,92,310,542,1190
46260,vinalesa,valencia/valencia,1360,506,632,2488,2134,7120
46261,yatova,valencia/valencia,626,304,462,1312,1792,4496
46262,"yesa,",valencia/valencia,42,32,50,126,220,470
46263,zarra,valencia/valencia,54,56,66,144,446,766
46902,gatova,valencia/valencia,90,50,106,204,416,866
46903,san,valencia/valencia,5492,1510,1416,7958,4776,21152
46904,benicull,valencia/valencia,344,178,282,684,792,2280
47001,adalia,valladolid,0,6,6,20,68,100
47002,aguasal,valladolid,0,2,0,10,26,38
47003,aguilar,valladolid,46,42,52,112,290,542
47004,alaejos,valladolid,302,136,258,756,1364,2816
47005,alcazaren,valladolid,130,74,106,338,578,1226
47006,aldea,valladolid,60,26,32,124,194,436
47007,aldeamayor,valladolid,2950,614,996,5458,2288,12306
47008,almenara,valladolid,0,2,4,10,28,44
47009,amusquillo,valladolid,8,6,16,42,126,198
47010,arroyo,valladolid,10778,2690,4258,18848,7926,44500
47011,ataquines,valladolid,74,56,104,282,642,1158
47012,bahabon,valladolid,12,6,14,48,112,192
47013,barcial,valladolid,8,10,10,34,140,202
47014,barruelo,valladolid,4,2,4,24,70,104
47015,becilla,valladolid,24,6,44,110,220,404
47016,benafarces,valladolid,4,4,6,26,98,138
47017,bercero,valladolid,10,10,32,74,228,354
47018,berceruelo,valladolid,0,2,14,14,42,72
47019,berrueces,valladolid,12,6,18,54,96,186
47020,bobadilla,valladolid,32,40,36,156,304,568
47021,bocigas,valladolid,12,0,12,42,82,148
47022,bocos,valladolid,4,14,14,56,74,162
47023,boecillo,valladolid,1984,630,710,3148,2266,8738
47024,bolanos,valladolid,46,26,44,122,270,508
47025,brahojos,valladolid,2,6,14,40,138,200
47026,bustillo,valladolid,22,14,14,32,52,134
47027,cabezon,valladolid,1556,566,766,2926,2010,7824
47028,cabezon,valladolid,12,4,2,12,34,64
47029,cabreros,valladolid,10,14,8,28,60,120
47030,campaspero,valladolid,184,86,168,506,1112,2056
47031,"campillo,",valladolid,36,14,42,94,214,400
47032,camporredondo,valladolid,10,8,40,72,164,294
47033,canalejas,valladolid,46,44,40,130,246,506
47034,canillas,valladolid,2,2,12,28,102,146
47035,carpio,valladolid,186,106,160,496,934,1882
47036,casasola,valladolid,22,22,24,118,244,430
47037,castrejon,valladolid,20,18,20,74,222,354
47038,castrillo,valladolid,22,12,16,68,126,244
47039,castrillo-tejeriego,valladolid,8,12,14,70,198,302
47040,castrobol,valladolid,0,0,10,12,68,90
47041,castrodeza,valladolid,10,12,28,70,166,286
47042,castromembibre,valladolid,6,10,6,26,50,98
47043,castromonte,valladolid,32,34,64,124,398,652
47044,castronuevo,valladolid,88,56,70,220,356,790
47045,castronuno,valladolid,144,60,120,350,872,1546
47046,castroponce,valladolid,18,12,28,50,154,262
47047,castroverde,valladolid,6,20,42,80,228,376
47048,ceinos,valladolid,22,26,22,80,198,348
47049,cervillego,valladolid,2,0,6,40,132,180
47050,cigales,valladolid,2152,738,1044,3958,2840,10732
47051,cigunuela,valladolid,88,30,74,226,298,716
47052,cisterniga,valladolid,3850,1340,1520,7128,4692,18530
47053,cogeces,valladolid,34,12,30,64,148,288
47054,cogeces,valladolid,96,78,90,318,706,1288
47055,corcos,valladolid,28,20,22,100,258,428
47056,corrales,valladolid,14,14,12,46,128,214
47057,cubillas,valladolid,82,34,82,254,360,812
47058,cuenca,valladolid,30,12,28,86,228,384
47059,curiel,valladolid,24,12,26,60,116,238
47060,encinas,valladolid,20,6,28,96,288,438
47061,esguevillas,valladolid,50,18,36,140,270,514
47062,fombellida,valladolid,24,16,20,88,202,350
47063,fompedraza,valladolid,32,6,16,70,102,226
47064,fontihoyuelo,valladolid,2,4,8,18,30,62
47065,fresno,valladolid,112,92,150,368,954,1676
47066,fuensaldana,valladolid,816,228,500,1436,1282,4262
47067,fuente,valladolid,4,18,24,88,174,308
47068,fuente-olmedo,valladolid,6,4,12,16,44,82
47069,gallegos,valladolid,2,16,20,46,134,218
47070,gaton,valladolid,16,6,8,16,38,84
47071,geria,valladolid,104,40,98,340,398,980
47073,herrin,valladolid,14,4,16,46,150,230
47074,hornillos,valladolid,38,10,30,116,154,348
47075,iscar,valladolid,2014,886,1280,3920,4744,12844
47076,laguna,valladolid,7730,3986,3796,14578,15680,45770
47077,langayo,valladolid,32,24,16,102,328,502
47078,lomoviejo,valladolid,22,16,22,74,190,324
47079,llano,valladolid,0,2,8,28,64,102
47080,manzanillo,valladolid,20,8,12,22,44,106
47081,marzales,valladolid,14,0,2,26,40,82
47082,matapozuelos,valladolid,272,146,232,574,806,2030
47083,matilla,valladolid,14,18,24,62,108,226
47084,mayorga,valladolid,266,150,278,738,1394,2826
47085,medina,valladolid,6120,2760,3930,11736,15750,40296
47086,medina,valladolid,1292,524,888,2586,3800,9090
47087,megeces,valladolid,84,50,84,192,438,848
47088,melgar,valladolid,14,4,30,28,152,228
47089,melgar,valladolid,10,8,24,92,192,326
47090,mojados,valladolid,1128,478,764,2212,2228,6810
47091,monasterio,valladolid,16,2,12,36,94,160
47092,montealegre,valladolid,18,0,24,60,112,214
47093,montemayor,valladolid,122,104,140,470,882,1718
47094,moral,valladolid,20,10,30,80,150,290
47095,moraleja,valladolid,0,2,4,22,48,76
47096,morales,valladolid,16,4,32,62,152,266
47097,mota,valladolid,46,32,64,160,362,664
47098,mucientes,valladolid,170,94,118,422,582,1386
47099,"mudarra,",valladolid,20,22,38,78,184,342
47100,muriel,valladolid,0,4,8,48,162,222
47101,nava,valladolid,530,220,328,1030,1750,3858
47102,nueva,valladolid,34,32,54,116,318,554
47103,olivares,valladolid,60,52,50,164,322,648
47104,olmedo,valladolid,1038,462,648,2096,2908,7152
47105,olmos,valladolid,32,24,30,114,198,398
47106,olmos,valladolid,2,2,0,24,48,76
47109,palazuelo,valladolid,20,16,26,98,162,322
47110,"parrilla,",valladolid,86,44,78,236,520,964
47111,pedraja,valladolid,250,144,262,644,1066,2366
47112,pedrajas,valladolid,982,504,718,1944,2648,6796
47113,pedrosa,valladolid,10,14,22,78,172,296
47114,penafiel,valladolid,1630,804,1022,2876,4036,10368
47115,penaflor,valladolid,52,34,52,210,356,704
47116,pesquera,valladolid,84,40,82,192,446,844
47117,pina,valladolid,58,42,48,174,302,624
47118,pinel,valladolid,26,12,34,80,178,330
47119,pinel,valladolid,12,4,12,42,106,176
47121,pollos,valladolid,74,64,102,262,628,1130
47122,portillo,valladolid,642,248,402,1458,2030,4780
47123,pozal,valladolid,138,74,96,320,448,1076
47124,pozaldez,valladolid,132,78,82,272,454,1018
47125,pozuelo,valladolid,2,2,8,26,68,106
47126,puras,valladolid,4,6,6,32,42,90
47127,quintanilla,valladolid,42,6,32,94,146,320
47128,quintanilla,valladolid,6,0,12,14,64,96
47129,quintanilla,valladolid,246,100,182,536,928,1992
47130,quintanilla,valladolid,12,8,12,60,110,202
47131,rabano,valladolid,22,16,18,54,242,352
47132,ramiro,valladolid,10,6,2,34,40,92
47133,renedo,valladolid,1912,574,486,3178,1796,7946
47134,roales,valladolid,12,12,32,82,188,326
47135,robladillo,valladolid,12,6,4,62,90,174
47137,roturas,valladolid,2,4,2,10,34,52
47138,rubi,valladolid,12,28,42,120,234,436
47139,rueda,valladolid,200,112,236,638,1050,2236
47140,saelices,valladolid,12,8,8,32,162,222
47141,salvador,valladolid,2,6,24,48,126,206
47142,san,valladolid,0,4,16,30,156,206
47143,san,valladolid,2,6,12,30,138,188
47144,san,valladolid,8,20,12,40,88,168
47145,san,valladolid,130,60,80,348,674,1292
47146,san,valladolid,128,50,54,288,222,742
47147,san,valladolid,8,12,26,46,122,214
47148,san,valladolid,78,46,66,240,444,874
47149,san,valladolid,12,6,6,22,48,94
47150,san,valladolid,66,42,44,184,266,602
47151,san,valladolid,0,4,2,8,32,46
47152,santa,valladolid,10,6,12,36,84,148
47153,santervas,valladolid,10,8,10,46,142,216
47154,santibanez,valladolid,22,2,20,118,212,374
47155,santovenia,valladolid,1822,640,1016,3516,2422,9416
47156,san,valladolid,36,16,24,88,160,324
47157,sardon,valladolid,140,64,146,320,542,1212
47158,"seca,",valladolid,276,122,216,566,848,2028
47159,serrada,valladolid,330,140,192,666,884,2212
47160,siete,valladolid,72,30,66,208,466,842
47161,simancas,valladolid,2214,1118,918,3188,3664,11102
47162,tamariz,valladolid,18,12,14,60,64,168
47163,tiedra,valladolid,24,6,54,130,350,564
47164,tordehumos,valladolid,62,46,102,180,370,760
47165,tordesillas,valladolid,2570,1172,1776,5196,6700,17414
47166,torrecilla,valladolid,36,14,68,92,290,500
47167,torrecilla,valladolid,16,26,32,92,288,454
47168,torrecilla,valladolid,2,2,4,12,36,56
47169,torre,valladolid,6,2,2,34,82,126
47170,torre,valladolid,4,6,12,26,66,114
47171,torrelobaton,valladolid,46,34,78,188,426,772
47172,torrescarcela,valladolid,46,18,24,80,164,332
47173,traspinedo,valladolid,338,116,250,822,962,2488
47174,trigueros,valladolid,66,30,40,174,318,628
47175,tudela,valladolid,2954,1312,1594,5716,6120,17696
47176,union,valladolid,26,10,30,68,322,456
47177,urones,valladolid,12,4,8,46,130,200
47178,uruena,valladolid,32,16,26,94,240,408
47179,valbuena,valladolid,74,34,38,240,430,816
47180,valdearcos,valladolid,16,4,8,32,74,134
47181,valdenebro,valladolid,40,18,26,106,182,372
47182,valdestillas,valladolid,424,266,314,1026,1226,3256
47183,valdunquillo,valladolid,6,6,12,38,178,240
47184,valoria,valladolid,196,68,150,476,608,1498
47185,valverde,valladolid,12,6,14,50,100,182
47186,valladolid,valladolid,84264,40510,55820,161558,257480,599632
47187,vega,valladolid,6,8,14,30,104,162
47188,vega,valladolid,12,0,12,40,118,182
47189,velascalvaro,valladolid,22,22,34,80,170,328
47190,velilla,valladolid,34,14,12,48,118,226
47191,velliza,valladolid,6,16,18,62,140,242
47192,ventosa,valladolid,2,18,12,44,126,202
47193,viana,valladolid,750,358,418,1528,1536,4590
47194,viloria,valladolid,70,36,54,184,334,678
47195,villabanez,valladolid,94,44,112,282,490,1022
47196,villabaruz,valladolid,4,2,0,14,44,64
47197,villabragima,valladolid,276,128,218,572,904,2098
47198,villacarralon,valladolid,6,4,10,28,86,134
47199,villacid,valladolid,6,6,16,46,90,164
47200,villaco,valladolid,4,8,14,40,84,150
47203,villafrades,valladolid,4,0,14,24,76,118
47204,villafranca,valladolid,28,28,34,104,290,484
47205,villafrechos,valladolid,128,66,102,242,394,932
47206,villafuerte,valladolid,10,2,4,48,108,172
47207,villagarcia,valladolid,50,26,44,156,298,574
47208,villagomez,valladolid,4,2,14,20,62,102
47209,villalan,valladolid,2,2,2,18,40,64
47210,villalar,valladolid,102,36,100,224,512,974
47211,villalba,valladolid,12,10,8,46,40,116
47212,villalba,valladolid,72,52,100,214,362,800
47213,villalbarba,valladolid,2,16,14,46,122,200
47214,villalon,valladolid,296,176,260,718,1560,3010
47215,villamuriel,valladolid,2,6,10,20,64,102
47216,villan,valladolid,24,12,28,64,116,244
47217,villanubla,valladolid,1286,402,450,2382,1310,5830
47218,villanueva,valladolid,372,130,224,822,970,2518
47219,villanueva,valladolid,12,8,10,46,42,118
47220,villanueva,valladolid,24,8,14,70,198,314
47221,villanueva,valladolid,20,6,12,64,124,226
47222,villanueva,valladolid,18,4,24,50,108,204
47223,villardefrades,valladolid,20,20,12,68,160,280
47224,villarmentero,valladolid,20,12,22,56,96,206
47225,villasexmir,valladolid,2,4,8,30,90,134
47226,villavaquerin,valladolid,28,2,36,82,142,290
47227,villavellid,valladolid,10,2,8,28,58,106
47228,villaverde,valladolid,170,62,110,336,392,1070
47229,villavicencio,valladolid,12,4,30,70,324,440
47230,wamba,valladolid,54,30,44,170,296,594
47231,zaratan,valladolid,2950,926,944,5198,2738,12756
47232,"zarza,",valladolid,10,14,26,82,106,238
48001,abadino,bizkaia,2744,994,1246,4972,5528,15484
48002,abanto,bizkaia,2664,1394,1668,5536,7554,18816
48003,amorebieta-etxano,bizkaia,6844,2672,3574,12086,14150,39326
48004,amoroto,bizkaia,114,72,80,188,330,784
48005,arakaldo,bizkaia,58,28,22,124,88,320
48006,arantzazu,bizkaia,132,68,52,270,266,788
48007,munitibar-arbatzegi,bizkaia,120,40,72,278,428,938
48008,artzentales,bizkaia,194,52,116,438,674,1474
48009,arrankudiaga-zollo,bizkaia,362,156,182,578,736,2014
48010,arrieta,bizkaia,142,80,122,322,492,1158
48011,arrigorriaga,bizkaia,3724,1876,2432,6686,9218,23936
48012,bakio,bizkaia,930,362,522,1874,1950,5638
48013,barakaldo,bizkaia,30738,12694,19518,62906,77882,203738
48014,barrika,bizkaia,472,236,234,946,1210,3098
48015,basauri,bizkaia,10364,5516,7424,22344,35166,80814
48016,berango,bizkaia,2904,1332,1292,4876,4926,15330
48017,bermeo,bizkaia,5318,2486,3130,9968,13282,34184
48018,berriatua,bizkaia,444,176,222,784,858,2484
48019,berriz,bizkaia,1608,714,752,2712,3388,9174
48020,bilbao,bizkaia,93656,48846,78024,192472,281686,694684
48021,busturia,bizkaia,490,222,250,934,1410,3306
48022,karrantza,bizkaia,674,320,500,1442,2476,5412
48023,artea,bizkaia,260,106,104,460,566,1496
48024,zeanuri,bizkaia,400,186,188,736,992,2502
48025,zeberio,bizkaia,340,138,170,622,894,2164
48026,dima,bizkaia,502,222,238,920,1128,3010
48027,durango,bizkaia,9796,4754,5972,17438,21754,59714
48028,ea,bizkaia,210,68,154,446,798,1676
48029,etxebarri,bizkaia,5076,1640,1588,8814,6782,23900
48030,etxebarria,bizkaia,256,96,192,380,620,1544
48031,elantxobe,bizkaia,84,30,52,196,334,696
48032,elorrio,bizkaia,2418,1104,1276,4002,5786,14586
48033,ereno,bizkaia,74,24,40,154,252,544
48034,ermua,bizkaia,4544,2150,2656,8876,13006,31232
48035,fruiz,bizkaia,226,80,78,386,382,1152
48036,galdakao,bizkaia,6950,3328,4678,13682,20898,49536
48037,galdames,bizkaia,244,90,94,476,742,1646
48038,gamiz-fika,bizkaia,392,174,256,708,1238,2768
48039,garai,bizkaia,132,60,38,202,254,686
48040,gatika,bizkaia,576,252,210,986,1240,3264
48041,gautegiz,bizkaia,238,122,204,436,760,1760
48042,gordexola,bizkaia,520,214,300,1038,1344,3416
48043,gorliz,bizkaia,1910,912,1012,3524,4670,12028
48044,getxo,bizkaia,22074,10710,14790,39286,65450,152310
48045,guenes,bizkaia,2230,944,1224,4230,4878,13506
48046,gernika-lumo,bizkaia,5782,2400,3116,9614,13106,34018
48047,gizaburuaga,bizkaia,70,32,58,120,112,392
48048,ibarrangelu,bizkaia,138,74,106,390,652,1360
48049,ispaster,bizkaia,266,94,88,382,598,1428
48050,izurtza,bizkaia,108,24,30,128,168,458
48051,lanestosa,bizkaia,46,32,40,120,254,492
48052,larrabetzu,bizkaia,784,326,318,1258,1394,4080
48053,laukiz,bizkaia,466,250,194,744,834,2488
48054,leioa,bizkaia,10910,4874,5984,19982,23580,65330
48055,lemoa,bizkaia,1338,452,608,2486,2274,7158
48056,lemoiz,bizkaia,486,178,194,944,876,2678
48057,lekeitio,bizkaia,1976,1130,1210,3784,6208,14308
48058,mallabia,bizkaia,358,122,178,722,930,2310
48059,manaria,bizkaia,214,38,86,340,388,1066
48060,markina-xemein,bizkaia,1892,724,872,2924,3746,10158
48061,maruri-jatabe,bizkaia,376,172,144,666,784,2142
48062,mendata,bizkaia,116,56,64,226,302,764
48063,mendexa,bizkaia,112,52,86,218,382,850
48064,menaka,bizkaia,246,84,100,464,638,1532
48065,ugao-miraballes,bizkaia,1342,564,804,2418,3224,8352
48066,morga,bizkaia,84,62,64,222,394,826
48067,muxika,bizkaia,604,192,202,926,1168,3092
48068,mundaka,bizkaia,512,180,286,1028,1654,3660
48069,mungia,bizkaia,6648,2838,3482,10936,12076,35980
48070,aulesti,bizkaia,200,96,90,348,552,1286
48071,muskiz,bizkaia,2278,1092,1250,4530,5564,14714
48072,otxandio,bizkaia,556,170,222,838,924,2710
48073,ondarroa,bizkaia,2150,1066,1540,4320,7182,16258
48074,urduna/orduna,bizkaia,1432,568,706,2352,3346,8404
48075,orozko,bizkaia,820,420,476,1564,2038,5318
48076,sukarrieta,bizkaia,64,44,52,176,372,708
48077,plentzia,bizkaia,1340,658,868,2540,3378,8784
48078,portugalete,bizkaia,11580,5628,7888,24406,40098,89600
48079,errigoiti,bizkaia,150,66,58,318,428,1020
48080,valle,bizkaia,3192,1628,2098,6904,9946,23768
48081,lezama,bizkaia,822,364,412,1372,1950,4920
48082,santurtzi,bizkaia,13336,5988,8438,27254,37472,92488
48083,ortuella,bizkaia,2578,1148,1640,5160,6706,17232
48084,sestao,bizkaia,8004,3996,5714,16146,22542,56402
48085,sopela,bizkaia,5734,2042,2734,9982,9354,29846
48086,sopuerta,bizkaia,916,334,432,1772,2064,5518
48087,trucios-turtzioz,bizkaia,110,52,68,320,482,1032
48088,ubide,bizkaia,46,14,30,128,124,342
48089,urduliz,bizkaia,2114,614,1280,3900,3510,11418
48090,balmaseda,bizkaia,2488,994,1280,4514,6066,15342
48091,atxondo,bizkaia,398,162,252,784,1114,2710
48092,bedia,bizkaia,314,158,202,652,896,2222
48093,areatza,bizkaia,480,218,230,788,826,2542
48094,igorre,bizkaia,1632,558,746,2514,3208,8658
48095,zaldibar,bizkaia,1094,384,484,1930,2144,6036
48096,zalla,bizkaia,2552,1068,1410,5028,6564,16622
48097,zaratamo,bizkaia,478,246,342,960,1190,3216
48901,derio,bizkaia,2694,950,1202,4980,4498,14324
48902,erandio,bizkaia,7434,3408,4604,15634,18270,49350
48903,loiu,bizkaia,834,346,400,1370,1758,4708
48904,sondika,bizkaia,1454,676,806,2668,3564,9168
48905,zamudio,bizkaia,1056,452,582,2032,2502,6624
48906,forua,bizkaia,286,118,142,540,810,1896
48907,kortezubi,bizkaia,172,64,62,244,352,894
48908,murueta,bizkaia,98,58,48,158,280,642
48909,nabarniz,bizkaia,98,32,52,150,216,548
48910,iurreta,bizkaia,1254,510,646,2344,2982,7736
48911,ajangiz,bizkaia,146,74,84,238,406,948
48912,alonsotegi,bizkaia,928,370,592,1908,2256,6054
48913,zierbena,bizkaia,398,190,272,1016,1108,2984
48914,arratzu,bizkaia,136,38,56,250,354,834
48915,ziortza-bolibar,bizkaia,142,22,78,222,352,816
48916,na,bizkaia,1566,562,822,2966,3220,9136
49002,abezames,zamora,8,2,10,34,66,120
49003,alcanices,zamora,202,100,206,628,1080,2216
49004,alcubilla,zamora,12,6,8,48,144,218
49005,alfaraz,zamora,20,4,24,62,138,248
49006,algodre,zamora,8,2,26,62,172,270
49007,almaraz,zamora,76,30,50,188,450,794
49008,almeida,zamora,36,30,58,160,560,844
49009,andavias,zamora,76,50,42,204,468,840
49010,arcenillas,zamora,172,30,104,306,286,898
49011,arcos,zamora,24,18,40,110,240,432
49012,arganin,zamora,22,10,10,40,78,160
49013,argujillo,zamora,24,24,34,82,272,436
49014,arquillinos,zamora,14,8,16,56,130,224
49015,arrabalde,zamora,10,18,10,60,290,388
49016,aspariegos,zamora,22,14,38,112,264,450
49017,asturianos,zamora,20,8,42,86,366,522
49018,ayoo,zamora,34,6,22,108,378,548
49019,barcial,zamora,50,26,30,132,278,516
49020,belver,zamora,18,14,36,112,326,506
49021,benavente,zamora,5198,2610,3400,9874,13372,34454
49022,benegiles,zamora,22,20,40,132,322,536
49023,bermillo,zamora,196,120,148,524,1080,2068
49024,boveda,zamora,90,64,116,352,728,1350
49025,breto,zamora,12,6,22,86,206,332
49026,bretocino,zamora,12,16,24,100,242,394
49027,brime,zamora,8,6,16,52,152,234
49028,brime,zamora,2,6,18,40,132,198
49029,burganes,zamora,82,48,140,278,688,1236
49030,bustillo,zamora,4,4,8,38,104,158
49031,cabanas,zamora,16,10,24,84,172,306
49032,calzadilla,zamora,32,26,34,110,376,578
49033,camarzana,zamora,106,78,142,322,858,1506
49034,canizal,zamora,56,46,50,188,504,844
49035,canizo,zamora,14,6,22,114,246,402
49036,carbajales,zamora,34,38,68,156,644,940
49037,carbellino,zamora,24,14,36,98,198,370
49038,casaseca,zamora,4,8,22,48,98,180
49039,casaseca,zamora,100,34,52,228,332,746
49040,castrillo,zamora,16,8,32,56,130,242
49041,castrogonzalo,zamora,50,58,68,228,464,868
49042,castronuevo,zamora,20,14,34,90,278,436
49043,castroverde,zamora,22,16,40,92,340,510
49044,cazurra,zamora,4,2,16,32,96,150
49046,cerecinos,zamora,8,36,68,90,264,466
49047,cerecinos,zamora,24,8,16,52,124,224
49048,cernadilla,zamora,4,2,14,40,160,220
49050,cobreros,zamora,106,46,74,262,602,1090
49052,coomonte,zamora,26,18,32,88,198,362
49053,coreses,zamora,238,120,218,520,978,2074
49054,corrales,zamora,198,110,126,488,936,1858
49055,cotanes,zamora,6,14,10,40,100,170
49056,cubillos,zamora,54,16,44,144,330,588
49057,cubo,zamora,10,12,10,56,152,240
49058,cubo,zamora,36,42,52,140,328,598
49059,cuelgamures,zamora,0,2,10,38,112,162
49061,entrala,zamora,12,6,26,56,156,256
49062,espadanedo,zamora,6,6,20,44,132,208
49063,faramontanos,zamora,50,24,48,154,400,676
49064,fariza,zamora,56,38,42,206,650,992
49065,fermoselle,zamora,202,108,168,510,1314,2302
49066,ferreras,zamora,78,36,60,202,528,904
49067,ferreras,zamora,52,38,34,160,432,716
49068,ferreruela,zamora,44,22,58,132,588,844
49069,figueruela,zamora,24,8,34,104,472,642
49071,fonfria,zamora,68,54,168,294,972,1556
49075,fresno,zamora,6,14,16,34,158,228
49076,fresno,zamora,64,38,78,176,326,682
49077,fresno,zamora,12,16,20,90,150,288
49078,friera,zamora,10,4,14,48,178,254
49079,fuente,zamora,6,2,6,40,126,180
49080,fuentelapena,zamora,80,30,86,274,728,1198
49081,fuentesauco,zamora,420,194,304,782,1516,3216
49082,fuentes,zamora,50,42,54,152,426,724
49083,fuentesecas,zamora,4,0,0,20,64,88
49084,fuentespreadas,zamora,52,30,30,168,304,584
49085,galende,zamora,168,108,204,478,1094,2052
49086,gallegos,zamora,12,16,30,46,128,232
49087,gallegos,zamora,24,18,50,196,648,936
49088,gamones,zamora,18,2,12,36,118,186
49090,gema,zamora,22,16,42,72,246,398
49091,granja,zamora,34,8,48,108,308,506
49092,granucillo,zamora,8,8,6,48,138,208
49093,guarrate,zamora,52,30,44,162,344,632
49094,hermisende,zamora,10,6,20,80,316,432
49095,"hiniesta,",zamora,66,26,58,168,302,620
49096,jambrina,zamora,14,12,18,82,170,296
49097,justel,zamora,2,2,4,36,112,156
49098,losacino,zamora,16,10,18,50,280,374
49099,losacio,zamora,18,0,16,34,110,178
49100,lubian,zamora,48,10,40,112,370,580
49101,luelmo,zamora,22,10,38,62,166,298
49102,"maderal,",zamora,12,12,30,72,216,342
49103,madridanos,zamora,108,48,80,230,448,914
49104,mahide,zamora,16,18,16,104,470,624
49105,maire,zamora,16,4,10,68,180,278
49107,malva,zamora,2,8,14,22,154,200
49108,manganeses,zamora,54,38,66,206,526,890
49109,manganeses,zamora,174,64,148,320,576,1282
49110,manzanal,zamora,30,22,48,122,484,706
49111,manzanal,zamora,14,10,14,52,170,260
49112,manzanal,zamora,18,4,18,62,172,274
49113,matilla,zamora,4,8,36,60,206,314
49114,matilla,zamora,2,0,8,10,52,72
49115,mayalde,zamora,16,8,26,84,170,304
49116,melgar,zamora,40,22,52,138,452,704
49117,micereces,zamora,48,20,52,186,520,826
49118,milles,zamora,16,20,32,96,234,398
49119,molacillos,zamora,46,22,34,132,230,464
49120,molezuelas,zamora,2,0,4,8,78,92
49121,mombuey,zamora,54,40,62,186,430,772
49122,monfarracinos,zamora,416,108,186,704,580,1994
49123,montamarta,zamora,104,42,108,284,550,1088
49124,moral,zamora,44,12,56,146,268,526
49125,moraleja,zamora,616,210,304,1252,1244,3626
49126,moraleja,zamora,48,26,50,128,346,598
49127,morales,zamora,1074,370,518,2068,2146,6176
49128,morales,zamora,78,50,86,204,624,1042
49129,morales,zamora,240,100,206,494,832,1872
49130,morales,zamora,4,2,10,52,232,300
49131,moralina,zamora,12,14,44,100,268,438
49132,moreruela,zamora,46,52,30,166,356,650
49133,moreruela,zamora,36,22,54,112,352,576
49134,muelas,zamora,14,12,34,92,226,378
49135,muelas,zamora,90,78,88,290,684,1230
49136,muga,zamora,46,46,70,162,326,650
49137,navianos,zamora,16,14,16,86,196,328
49138,olmillos,zamora,8,20,20,48,290,386
49139,otero,zamora,6,10,26,62,228,332
49141,pajares,zamora,28,30,36,94,374,562
49142,palacios,zamora,38,18,36,112,276,480
49143,palacios,zamora,40,22,34,94,270,460
49145,pedralba,zamora,36,16,18,90,238,398
49146,"pego,",zamora,30,26,40,136,340,572
49147,peleagonzalo,zamora,70,22,50,116,330,588
49148,peleas,zamora,44,16,36,78,336,510
49149,penausende,zamora,76,38,66,202,400,782
49150,peque,zamora,8,8,14,52,162,244
49151,"perdigon,",zamora,156,64,94,336,646,1296
49152,pereruela,zamora,76,52,100,210,558,996
49153,perilla,zamora,14,10,16,68,190,298
49154,pias,zamora,2,2,10,26,146,186
49155,piedrahita,zamora,12,14,12,52,122,212
49156,pinilla,zamora,4,18,28,74,268,392
49157,pino,zamora,14,20,46,76,194,350
49158,"pinero,",zamora,38,20,46,90,238,432
49159,pobladura,zamora,40,30,38,146,294,548
49160,pobladura,zamora,4,0,4,20,44,72
49162,porto,zamora,6,0,28,70,206,310
49163,pozoantiguo,zamora,14,4,20,88,270,396
49164,pozuelo,zamora,14,10,34,68,164,290
49165,prado,zamora,0,6,8,18,76,108
49166,puebla,zamora,286,168,270,776,1242,2742
49167,pueblica,zamora,12,12,22,54,256,356
49168,quintanilla,zamora,8,2,14,54,114,192
49169,quintanilla,zamora,0,0,0,32,58,90
49170,quintanilla,zamora,10,2,20,50,112,194
49171,quiruelas,zamora,108,38,96,284,744,1270
49172,rabanales,zamora,40,40,80,222,596,978
49173,rabano,zamora,54,12,24,126,420,636
49174,requejo,zamora,12,12,12,62,134,232
49175,revellinos,zamora,66,18,30,118,246,478
49176,riofrio,zamora,50,46,78,240,786,1200
49177,rionegro,zamora,12,28,44,92,288,464
49178,roales,zamora,386,108,212,736,602,2044
49179,robleda-cervantes,zamora,80,34,68,216,402,800
49180,roelos,zamora,6,14,20,60,176,276
49181,rosinos,zamora,24,18,46,98,424,610
49183,salce,zamora,10,2,12,38,108,170
49184,samir,zamora,8,12,38,32,224,314
49185,san,zamora,26,30,22,82,178,338
49186,san,zamora,16,10,36,106,332,500
49187,san,zamora,316,164,202,704,1262,2648
49188,san,zamora,8,6,20,52,132,218
49189,san,zamora,32,26,40,88,250,436
49190,san,zamora,0,2,0,18,70,90
49191,san,zamora,20,16,28,134,304,502
49192,san,zamora,14,6,18,54,144,236
49193,san,zamora,30,46,68,200,504,848
49194,san,zamora,30,20,54,128,426,658
49197,santa,zamora,26,4,18,70,200,318
49199,santa,zamora,36,12,24,108,288,468
49200,santa,zamora,244,88,158,546,1028,2064
49201,santa,zamora,30,16,34,90,352,522
49202,santa,zamora,10,8,12,92,216,338
49203,santa,zamora,32,30,44,126,348,580
49204,santa,zamora,0,0,6,10,86,102
49205,santibanez,zamora,46,30,54,150,440,720
49206,santibanez,zamora,146,94,128,404,922,1694
49207,santovenia,zamora,22,22,34,110,264,452
49208,san,zamora,24,12,48,158,406,648
49209,san,zamora,50,22,50,192,542,856
49210,sanzoles,zamora,68,40,90,234,508,940
49214,tabara,zamora,134,88,116,384,786,1508
49216,tapioles,zamora,8,0,4,64,172,248
49219,toro,zamora,2130,1068,1498,4584,7462,16742
49220,torre,zamora,12,12,16,54,158,252
49221,torregamones,zamora,38,22,38,100,258,456
49222,torres,zamora,100,34,94,220,374,822
49223,trabazos,zamora,78,64,126,404,998,1670
49224,trefacio,zamora,32,12,24,92,174,334
49225,una,zamora,22,0,10,54,156,242
49226,vadillo,zamora,24,16,30,122,298,490
49227,valcabado,zamora,144,38,84,254,310,830
49228,valdefinjas,zamora,2,4,10,34,68,118
49229,valdescorriel,zamora,20,10,22,68,142,262
49230,vallesa,zamora,4,2,0,24,106,136
49231,vega,zamora,48,30,36,130,330,574
49232,vega,zamora,6,6,22,42,106,182
49233,vegalatrave,zamora,12,0,12,24,110,158
49234,venialbo,zamora,80,32,78,228,460,878
49235,vezdemarban,zamora,80,40,84,194,476,874
49236,vidayanes,zamora,18,2,16,36,82,154
49237,videmala,zamora,10,8,22,58,188,286
49238,villabrazaro,zamora,32,20,44,182,262,540
49239,villabuena,zamora,72,54,88,224,734,1172
49240,villadepera,zamora,20,20,26,70,222,358
49241,villaescusa,zamora,16,18,26,104,310,474
49242,villafafila,zamora,52,46,82,174,526,880
49243,villaferruena,zamora,8,4,16,32,156,216
49244,villageriz,zamora,0,12,14,30,70,126
49245,villalazan,zamora,22,28,40,114,292,496
49246,villalba,zamora,20,18,26,76,282,422
49247,villalcampo,zamora,24,6,28,142,558,758
49248,villalobos,zamora,32,16,30,102,204,384
49249,villalonso,zamora,32,6,8,40,80,166
49250,villalpando,zamora,332,188,186,776,1310,2792
49251,villalube,zamora,6,12,16,64,196,294
49252,villamayor,zamora,42,36,60,156,384,678
49255,villamor,zamora,26,14,40,178,486,744
49256,villanazar,zamora,34,20,44,122,284,504
49257,villanueva,zamora,106,42,94,238,286,766
49258,villanueva,zamora,6,14,24,52,138,234
49259,villanueva,zamora,12,4,14,26,122,178
49260,villanueva,zamora,180,62,112,360,830,1544
49261,villaralbo,zamora,512,190,314,1110,1486,3612
49262,villardeciervos,zamora,40,42,72,174,462,790
49263,villar,zamora,2,2,4,20,70,98
49264,villar,zamora,58,38,54,200,684,1034
49265,villardiegua,zamora,16,4,20,56,136,232
49266,villardiga,zamora,2,6,8,22,86,124
49267,villardondiego,zamora,28,18,16,72,118,252
49268,villarrin,zamora,42,24,68,120,574,828
49269,villaseco,zamora,18,8,44,92,252,414
49270,villavendimio,zamora,38,24,28,92,146,328
49271,villaveza,zamora,2,6,20,60,238,326
49272,villaveza,zamora,2,2,6,20,114,144
49273,vinas,zamora,12,12,18,50,232,324
49275,zamora,zamora,15962,7854,10272,32216,52802,119106
50001,abanto,zaragoza,4,14,6,30,108,162
50002,acered,zaragoza,22,16,20,66,158,282
50003,agon,zaragoza,14,18,12,78,144,266
50004,aguaron,zaragoza,110,62,118,314,588,1192
50005,aguilon,zaragoza,24,18,44,126,334,546
50006,ainzon,zaragoza,240,152,194,540,962,2088
50007,aladren,zaragoza,6,4,24,24,66,124
50008,alagon,zaragoza,2524,1104,1536,4684,5000,14848
50009,alarba,zaragoza,4,6,14,34,128,186
50010,alberite,zaragoza,14,12,24,24,92,166
50011,albeta,zaragoza,28,20,40,72,124,284
50012,alborge,zaragoza,20,8,26,60,90,204
50013,alcala,zaragoza,50,24,50,152,210,486
50014,alcala,zaragoza,28,12,20,90,158,308
50015,alconchel,zaragoza,8,6,10,46,88,158
50016,aldehuela,zaragoza,0,2,8,22,66,98
50017,alfajarin,zaragoza,888,328,404,1558,1636,4814
50018,alfamen,zaragoza,512,206,378,860,1004,2960
50019,alforque,zaragoza,0,4,6,30,82,122
50020,alhama,zaragoza,230,122,174,552,772,1850
50021,almochuel,zaragoza,0,0,0,12,32,44
50022,"almolda,",zaragoza,90,46,114,286,552,1088
50023,almonacid,zaragoza,32,44,42,118,232,468
50024,almonacid,zaragoza,212,88,132,460,622,1514
50025,almunia,zaragoza,2904,1348,1746,5032,4880,15910
50026,alpartir,zaragoza,164,106,110,344,460,1184
50027,ambel,zaragoza,46,32,30,154,246,508
50028,anento,zaragoza,4,34,40,52,94,224
50029,aninon,zaragoza,154,78,180,298,648,1358
50030,anon,zaragoza,52,8,26,118,240,444
50031,aranda,zaragoza,6,10,18,36,160,230
50032,arandiga,zaragoza,50,36,44,136,264,530
50033,ardisa,zaragoza,0,4,10,40,98,152
50034,ariza,zaragoza,342,144,176,582,920,2164
50035,artieda,zaragoza,10,8,32,42,80,172
50036,asin,zaragoza,12,0,18,42,108,180
50037,atea,zaragoza,6,30,20,60,154,270
50038,ateca,zaragoza,404,218,360,842,1630,3454
50039,azuara,zaragoza,74,60,116,294,536,1080
50040,badules,zaragoza,6,6,18,46,88,164
50041,bagues,zaragoza,4,4,0,10,20,38
50042,balconchan,zaragoza,0,0,4,4,30,38
50043,barboles,zaragoza,62,26,70,162,250,570
50044,bardallur,zaragoza,38,30,24,128,234,454
50045,belchite,zaragoza,336,228,266,808,1386,3024
50046,belmonte,zaragoza,20,26,24,84,206,360
50047,berdejo,zaragoza,4,2,2,22,46,76
50048,berrueco,zaragoza,0,2,8,10,46,66
50050,bijuesca,zaragoza,6,8,24,50,100,188
50051,biota,zaragoza,160,128,132,422,836,1678
50052,bisimbre,zaragoza,6,12,18,48,98,182
50053,boquineni,zaragoza,172,70,146,386,746,1520
50054,bordalba,zaragoza,0,0,6,20,68,94
50055,borja,zaragoza,1904,772,1040,3030,3564,10310
50056,botorrita,zaragoza,176,62,108,394,424,1164
50057,brea,zaragoza,358,200,264,810,1392,3024
50058,bubierca,zaragoza,2,4,0,42,66,114
50059,bujaraloz,zaragoza,256,152,196,520,794,1918
50060,bulbuente,zaragoza,50,26,44,134,224,478
50061,bureta,zaragoza,34,12,38,102,230,416
50062,burgo,zaragoza,978,378,554,1846,1732,5488
50063,"buste,",zaragoza,6,4,4,40,64,118
50064,cabanas,zaragoza,98,50,98,240,464,950
50065,cabolafuente,zaragoza,0,2,4,24,72,102
50066,cadrete,zaragoza,1894,608,908,3516,2372,9298
50067,calatayud,zaragoza,6274,3084,4566,11374,14370,39668
50068,calatorao,zaragoza,984,398,522,1740,2096,5740
50069,calcena,zaragoza,4,2,8,38,92,144
50070,calmarza,zaragoza,14,4,0,34,64,116
50071,campillo,zaragoza,4,22,14,60,126,226
50072,carenas,zaragoza,4,12,30,84,202,332
50073,carinena,zaragoza,1188,514,774,2174,2356,7006
50074,caspe,zaragoza,4016,1644,2290,6076,6712,20738
50075,castejon,zaragoza,2,14,12,40,90,158
50076,castejon,zaragoza,0,14,6,54,106,180
50077,castejon,zaragoza,20,12,28,110,226,396
50078,castiliscar,zaragoza,26,8,44,84,266,428
50079,cervera,zaragoza,54,28,34,150,254,520
50080,cerveruela,zaragoza,2,0,2,20,50,74
50081,cetina,zaragoza,134,72,138,264,500,1108
50082,cimballa,zaragoza,16,2,10,36,98,162
50083,cinco,zaragoza,12,4,14,66,104,200
50084,clares,zaragoza,6,2,8,54,74,144
50085,codo,zaragoza,28,28,26,114,206,402
50086,codos,zaragoza,76,50,44,80,210,460
50087,contamina,zaragoza,4,0,2,14,46,66
50088,cosuenda,zaragoza,74,28,48,200,310,660
50089,cuarte,zaragoza,8096,1896,2966,12158,5012,30128
50090,cubel,zaragoza,30,12,16,76,152,286
50091,"cuerlas,",zaragoza,0,2,4,10,66,82
50092,chiprana,zaragoza,164,90,98,354,316,1022
50093,chodes,zaragoza,16,10,22,62,94,204
50094,daroca,zaragoza,542,240,476,1036,1560,3854
50095,ejea,zaragoza,5668,2492,3632,10084,12324,34200
50096,embid,zaragoza,2,0,4,4,48,58
50098,encinacorba,zaragoza,20,14,22,96,216,368
50099,epila,zaragoza,1792,768,1016,2588,2910,9074
50100,erla,zaragoza,96,34,54,176,384,744
50101,escatron,zaragoza,360,120,248,616,998,2342
50102,fabara,zaragoza,256,138,186,548,960,2088
50104,farlete,zaragoza,54,58,64,186,426,788
50105,fayon,zaragoza,130,38,112,240,336,856
50106,"fayos,",zaragoza,18,6,36,48,160,268
50107,figueruelas,zaragoza,358,192,312,698,986,2546
50108,fombuena,zaragoza,2,2,10,34,62,110
50109,"frago,",zaragoza,34,8,30,78,118,268
50110,"frasno,",zaragoza,38,28,78,184,404,732
50111,frescano,zaragoza,36,16,40,98,200,390
50113,fuendejalon,zaragoza,188,100,160,446,678,1572
50114,fuendetodos,zaragoza,22,20,12,72,160,286
50115,fuentes,zaragoza,1612,762,912,2842,3184,9312
50116,fuentes,zaragoza,30,22,24,114,230,420
50117,gallocanta,zaragoza,22,22,36,52,128,260
50118,gallur,zaragoza,722,320,494,1458,2210,5204
50119,gelsa,zaragoza,236,120,170,476,974,1976
50120,godojos,zaragoza,10,4,12,24,58,108
50121,gotor,zaragoza,46,52,84,140,306,628
50122,grisel,zaragoza,24,10,14,50,94,192
50123,grisen,zaragoza,208,88,172,344,440,1252
50124,herrera,zaragoza,104,74,110,260,458,1006
50125,ibdes,zaragoza,68,60,62,172,388,750
50126,illueca,zaragoza,608,404,520,1544,2366,5442
50128,isuerre,zaragoza,6,2,8,8,36,60
50129,jaraba,zaragoza,108,36,52,176,218,590
50130,jarque,zaragoza,70,48,74,218,358,768
50131,jaulin,zaragoza,54,26,62,134,310,586
50132,"joyosa,",zaragoza,486,168,236,788,586,2264
50133,lagata,zaragoza,14,6,16,48,146,230
50134,langa,zaragoza,10,0,18,46,146,220
50135,layana,zaragoza,18,16,10,56,96,196
50136,lecera,zaragoza,110,58,134,278,616,1196
50137,lecinena,zaragoza,272,128,138,558,1086,2182
50138,lechon,zaragoza,0,6,8,20,54,88
50139,letux,zaragoza,38,52,58,144,418,710
50140,litago,zaragoza,24,26,24,106,204,384
50141,lituenigo,zaragoza,28,6,20,52,142,248
50142,lobera,zaragoza,2,2,4,8,38,54
50143,longares,zaragoza,198,100,202,526,618,1644
50144,longas,zaragoza,0,0,8,14,68,90
50146,lucena,zaragoza,64,22,30,120,216,452
50147,luceni,zaragoza,304,104,222,554,822,2006
50148,luesia,zaragoza,50,38,104,126,360,678
50149,luesma,zaragoza,0,4,4,28,46,82
50150,lumpiaque,zaragoza,260,100,186,468,722,1736
50151,luna,zaragoza,106,76,160,270,742,1354
50152,maella,zaragoza,660,318,332,1236,1590,4136
50153,magallon,zaragoza,284,154,214,620,914,2186
50154,mainar,zaragoza,34,16,54,98,140,342
50155,malanquilla,zaragoza,4,4,8,58,72,146
50156,malejan,zaragoza,78,36,68,142,232,556
50157,malon,zaragoza,144,82,100,236,320,882
50159,maluenda,zaragoza,242,130,200,530,728,1830
50160,mallen,zaragoza,916,390,644,1868,2264,6082
50161,manchones,zaragoza,12,8,12,48,114,194
50162,mara,zaragoza,38,20,22,90,158,328
50163,maria,zaragoza,3524,982,970,5168,2334,12978
50164,mediana,zaragoza,118,46,120,256,372,912
50165,mequinenza,zaragoza,650,312,456,1230,1818,4466
50166,mesones,zaragoza,40,14,46,126,306,532
50167,mezalocha,zaragoza,18,12,32,100,252,414
50168,mianos,zaragoza,0,4,2,18,32,56
50169,miedes,zaragoza,80,50,92,212,374,808
50170,monegrillo,zaragoza,50,32,66,182,422,752
50171,moneva,zaragoza,20,14,18,68,120,240
50172,monreal,zaragoza,10,16,22,92,204,344
50173,monterde,zaragoza,10,2,22,82,192,308
50174,monton,zaragoza,12,6,10,42,120,190
50175,morata,zaragoza,224,134,228,554,1032,2172
50176,morata,zaragoza,42,20,86,118,232,498
50177,mores,zaragoza,50,46,38,144,332,610
50178,moros,zaragoza,12,40,48,90,348,538
50179,moyuela,zaragoza,4,16,36,78,320,454
50180,mozota,zaragoza,30,8,26,78,118,260
50181,muel,zaragoza,462,226,314,886,1094,2982
50182,"muela,",zaragoza,3020,854,1654,5038,2572,13138
50183,munebrega,zaragoza,56,58,76,192,354,736
50184,murero,zaragoza,6,4,22,26,126,184
50185,murillo,zaragoza,54,12,46,140,156,408
50186,navardun,zaragoza,0,0,4,20,52,76
50187,niguella,zaragoza,2,2,14,34,72,124
50188,nombrevilla,zaragoza,6,8,0,22,42,78
50189,nonaspe,zaragoza,292,168,222,534,818,2034
50190,novallas,zaragoza,254,112,176,508,672,1722
50191,novillas,zaragoza,80,62,106,222,534,1004
50192,nuevalos,zaragoza,82,52,42,206,238,620
50193,nuez,zaragoza,328,106,160,584,634,1812
50194,olves,zaragoza,22,12,18,70,102,224
50195,orcajo,zaragoza,2,2,10,22,82,118
50196,orera,zaragoza,10,24,26,36,106,202
50197,ores,zaragoza,10,8,14,40,76,148
50198,oseja,zaragoza,0,8,6,26,48,88
50199,osera,zaragoza,112,40,68,272,366,858
50200,paniza,zaragoza,128,52,90,312,566,1148
50201,paracuellos,zaragoza,156,90,124,388,468,1226
50202,paracuellos,zaragoza,2,2,6,68,146,224
50203,pastriz,zaragoza,394,188,244,818,984,2628
50204,pedrola,zaragoza,1304,546,808,2334,2522,7514
50205,"pedrosas,",zaragoza,22,6,12,78,108,226
50206,perdiguera,zaragoza,136,110,84,308,448,1086
50207,piedratajada,zaragoza,4,6,24,38,122,194
50208,pina,zaragoza,798,430,550,1360,1752,4890
50209,pinseque,zaragoza,1938,582,908,3430,2224,9082
50210,"pintanos,",zaragoza,0,0,2,8,68,78
50211,plasencia,zaragoza,106,42,86,236,292,762
50212,pleitas,zaragoza,8,0,6,14,32,60
50213,plenas,zaragoza,18,6,16,62,124,226
50214,pomer,zaragoza,0,4,8,12,24,48
50215,pozuel,zaragoza,10,0,2,10,26,48
50216,pozuelo,zaragoza,42,28,60,120,248,498
50217,pradilla,zaragoza,116,80,140,310,484,1130
50218,puebla,zaragoza,14,20,36,68,136,274
50219,puebla,zaragoza,3068,990,1142,5158,2678,13036
50220,puendeluna,zaragoza,0,2,6,18,58,84
50221,purujosa,zaragoza,0,0,4,16,38,58
50222,quinto,zaragoza,574,244,382,1006,1554,3760
50223,remolinos,zaragoza,212,128,188,582,938,2048
50224,retascon,zaragoza,10,8,16,40,72,146
50225,ricla,zaragoza,780,504,744,2070,1898,5996
50227,romanos,zaragoza,22,4,28,78,156,288
50228,rueda,zaragoza,92,20,70,156,314,652
50229,ruesca,zaragoza,12,10,24,30,62,138
50230,sadaba,zaragoza,240,160,262,622,1252,2536
50231,salillas,zaragoza,114,50,62,232,264,722
50232,salvatierra,zaragoza,66,28,46,80,166,386
50233,samper,zaragoza,14,4,10,36,100,164
50234,san,zaragoza,72,24,52,152,248,548
50235,san,zaragoza,1184,496,722,2230,2202,6834
50236,santa,zaragoza,16,4,22,54,112,208
50237,santa,zaragoza,32,20,14,86,96,248
50238,santa,zaragoza,18,4,22,44,114,202
50239,santed,zaragoza,2,2,8,48,82,142
50240,sastago,zaragoza,296,126,184,570,1010,2186
50241,sabinan,zaragoza,168,60,112,376,664,1380
50242,sediles,zaragoza,28,6,14,60,116,224
50243,sestrica,zaragoza,28,36,82,156,378,680
50244,sierra,zaragoza,68,40,50,124,232,514
50245,sigues,zaragoza,14,6,6,32,84,142
50246,sisamon,zaragoza,2,0,2,12,78,94
50247,sobradiel,zaragoza,438,136,232,750,718,2274
50248,sos,zaragoza,122,54,114,298,584,1172
50249,tabuenca,zaragoza,40,36,40,146,360,622
50250,talamantes,zaragoza,22,6,12,32,92,164
50251,tarazona,zaragoza,3498,1666,2306,6082,7980,21532
50252,tauste,zaragoza,2028,1028,1442,3646,5426,13570
50253,terrer,zaragoza,130,34,136,350,504,1154
50254,tierga,zaragoza,14,26,26,94,194,354
50255,tobed,zaragoza,34,8,20,110,220,392
50256,torralba,zaragoza,6,0,6,34,90,136
50257,torralba,zaragoza,8,12,36,88,194,338
50258,torralbilla,zaragoza,0,2,10,14,52,78
50259,torrehermosa,zaragoza,10,16,6,36,88,156
50260,torrelapaja,zaragoza,0,0,0,8,50,58
50261,torrellas,zaragoza,56,20,24,136,226,462
50262,torres,zaragoza,490,166,286,976,1090,3008
50263,torrijo,zaragoza,22,12,42,76,234,386
50264,tosos,zaragoza,30,16,26,86,194,352
50265,trasmoz,zaragoza,24,6,10,48,78,166
50266,trasobares,zaragoza,10,6,14,72,142,244
50267,uncastillo,zaragoza,82,86,94,288,680,1230
50268,undues,zaragoza,14,16,6,52,22,110
50269,urrea,zaragoza,146,44,64,272,348,874
50270,urries,zaragoza,6,0,8,24,60,98
50271,used,zaragoza,28,32,42,140,284,526
50272,utebo,zaragoza,7762,3322,3486,12964,10434,37968
50273,valdehorna,zaragoza,0,0,10,18,34,62
50274,val,zaragoza,2,4,4,38,70,118
50275,valmadrid,zaragoza,12,18,20,58,146,254
50276,valpalmas,zaragoza,2,6,28,50,168,254
50277,valtorres,zaragoza,24,18,10,38,62,152
50278,velilla,zaragoza,50,34,34,106,186,410
50279,velilla,zaragoza,10,8,24,30,80,152
50280,vera,zaragoza,32,22,50,156,372,632
50281,vierlas,zaragoza,24,12,30,40,74,180
50282,"viluena,",zaragoza,14,2,2,26,74,118
50283,villadoz,zaragoza,28,8,12,38,76,162
50284,villafeliche,zaragoza,22,30,28,68,164,312
50285,villafranca,zaragoza,242,120,166,484,654,1666
50286,villalba,zaragoza,26,8,6,40,88,168
50287,villalengua,zaragoza,56,24,58,128,312,578
50288,villanueva,zaragoza,1744,884,1004,2884,3102,9618
50289,villanueva,zaragoza,6,6,6,40,80,138
50290,villanueva,zaragoza,46,48,70,160,434,758
50291,villar,zaragoza,34,30,26,68,156,314
50292,villarreal,zaragoza,80,42,92,168,152,534
50293,villarroya,zaragoza,56,48,76,194,450,824
50294,villarroya,zaragoza,8,0,6,34,88,136
50295,vistabella,zaragoza,0,4,8,14,76,102
50296,"zaida,",zaragoza,82,40,96,208,436,862
50297,zaragoza,zaragoza,222708,101850,149074,404112,504330,1382074
50298,zuera,zaragoza,3266,1286,1904,5690,5124,17270
50901,biel,zaragoza,12,16,32,74,206,340
50902,marracos,zaragoza,8,4,8,66,84,170
50903,villamayor,zaragoza,810,448,640,1578,2228,5704
51001,ceuta,ceuta,36302,16772,21570,47926,43788,166358
52001,melilla,melilla,42172,17412,23392,46814,42180,171970
